阿	aF
挨	aiA
捱	aiAP
癌	aiB
皑	aiBP
凒	aiBQ
皚	aiBS
皧	aiBT
賹	aiBU
溰	aiEQ
溾	aiES
濭	aiET
隘	aiF
絠	aiFQ
阨	aiFS
隑	aiFT
焥	aiHQ
锿	aiJ
鎄	aiJQ
鑀	aiJS
哀	aiK
毐	aiMQ
瞹	aiMS
騃	aiMT
嫒	aiN
娭	aiNQ
娾	aiNS
嬡	aiNT
鴱	aiNU
唉	aiO
嗳	aiOC
嗌	aiOD
哎	aiOP
啀	aiOQ
嘊	aiOS
噯	aiOT
碍	aiP
砹	aiPP
礙	aiPQ
硋	aiPS
硙	aiPT
磑	aiPU
欬	aiQQ
欸	aiQS
霭	aiR
暧	aiRP
昹	aiRQ
曖	aiRS
靄	aiRT
靉	aiRU
矮	aiS
嵦	aiSQ
躷	aiSS
餲	aiST
埃	aiT
堨	aiTQ
塧	aiTS
壒	aiTT
艾	aiU
蔼	aiUP
藹	aiUQ
薆	aiUS
﨟	aiUT
伌	aiVQ
佁	aiVS
僾	aiVT
瑷	aiW
敱	aiWQ
敳	aiWS
璦	aiWT
愛	aiXQ
懓	aiXS
懝	aiXT
馤	aiXU
叆	aiYQ
誒	aiYS
諰	aiYT
譪	aiYU
譺	aiYV
鱫	aiYW
爱	aiZ
锕	aJ
錒	aJQ
腌	aL
按	anA
揞	anAP
安	anB
痷	anBQ
厈	anCQ
洝	anEQ
隌	anFQ
鞍	anG
骯	angGQ
枊	angIQ
卬	angJQ
肮	angL
盎	angM
庵	anGP
鞌	anGQ
醠	angQQ
昂	angR
昻	angRQ
岇	angSQ
黯	anH
案	anI
桉	anIP
铵	anJ
銨	anJQ
錌	anJS
裺	anKQ
胺	anL
腤	anLQ
盦	anMQ
盫	anMS
闇	anMT
鹌	anN
婩	anNQ
媕	anNS
鵪	anNT
鶕	anNU
咹	anOQ
唵	anOS
啽	anOT
氨	anQ
犴	anQP
暗	anR
晻	anRQ
雸	anRS
岸	anS
屵	anSQ
屽	anSS
峖	anST
罯	anSU
埯	anT
垵	anTQ
堓	anTS
荌	anUQ
菴	anUS
萻	anUT
葊	anUU
蓭	anUV
俺	anV
侒	anVQ
偣	anVS
儑	anVT
玵	anWQ
馣	anXQ
谙	anY
誝	anYQ
諳	anYS
韽	anYT
鮟	anYU
豻	anZQ
貋	anZS
啊	aO
拗	aoA
扷	aoAQ
抝	aoAS
摮	aoAT
擙	aoAV
镺	aoBQ
螯	aoC
厫	aoCQ
軪	aoCS
奥	aoD
奡	aoDQ
奧	aoDS
澳	aoE
泑	aoEQ
滶	aoES
澚	aoET
聱	aoF
郩	aoFQ
隞	aoFT
隩	aoFU
廒	aoG
熬	aoH
熝	aoHQ
爊	aoHS
柪	aoIQ
梎	aoIS
鏊	aoJ
鏕	aoJQ
袄	aoK
襖	aoKQ
凹	aoL
鏖	aoLP
骜	aoM
眑	aoMQ
驁	aoMT
鼇	aoMU
媪	aoN
媼	aoNQ
嫯	aoNS
鷔	aoNT
嗷	aoO
嗸	aoOQ
囂	aoOS
嗄	aOP
磝	aoPQ
獒	aoQ
獓	aoQQ
吖	aOR
岙	aoS
岰	aoSQ
嶅	aoSS
嶴	aoSU
坳	aoT
垇	aoTQ
墺	aoTS
墽	aoTT
芺	aoUS
蔜	aoUU
傲	aoV
敖	aoW
璈	aoWQ
懊	aoX
慠	aoXU
鳌	aoY
翱	aoYP
翶	aoYQ
翺	aoYS
謷	aoYT
謸	aoYU
鰲	aoYV
遨	aoZ
醃	aQQ
把	baA
扒	baAC
捌	baAD
拔	baAP
扷	baAQ
抜	baAS
八	baB
疤	baBP
丷	baBQ
癹	baBS
巼	baBU
蚆	baCQ
軷	baCS
夿	baDQ
巴	baE
灞	baEP
爸	baF
颰	baFQ
靶	baG
魃	baGP
弝	baGQ
炦	baHQ
摆	baiA
掰	baiAC
捭	baiAD
拜	baiAP
擺	baiAQ
拝	baiAS
挀	baiAT
白	baiB
败	baiBC
百	baiBP
贁	baiBQ
絔	baiFQ
庍	baiGQ
稗	baiH
柏	baiI
栢	baiIQ
兡	baiKQ
襬	baiKS
竡	baiLQ
粨	baiMQ
粺	baiMS
犤	baiNQ
唄	baiOQ
朳	baIQ
猈	baiQQ
柭	baIS
欛	baIT
薭	baiUQ
佰	baiV
瓸	baIW
敗	baiWQ
韛	baiWS
钯	baJ
釟	baJQ
鈀	baJS
笆	baK
耙	baL
胈	baLQ
粑	baM
搬	banA
拌	banAC
扳	banAD
扮	banAP
搫	banAQ
半	banB
癍	banBC
瘢	banBP
蝂	banCQ
螁	banCS
螌	banCT
湴	banEQ
绊	banF
阪	banFP
絆	banFQ
瓣	banG
挷	bangAQ
捠	bangAS
搒	bangAT
蚌	bangC
蚄	bangCQ
蛖	bangCS
蜯	bangCT
浜	bangE
邦	bangF
绑	bangFP
綁	bangFQ
縍	bangFS
邫	bangFT
鞤	bangGQ
髈	bangGS
稖	bangHQ
棒	bangI
梆	bangIC
榜	bangIP
棓	bangIQ
帮	bangJ
镑	bangJP
幫	bangJQ
鎊	bangJS
幇	bangJT
幚	bangJU
膀	bangL
磅	bangP
牓	bangPQ
硥	bangPS
靽	banGQ
垹	bangTQ
塝	bangTS
蒡	bangU
傍	bangV
玤	bangWQ
谤	bangY
謗	bangYQ
艕	bangZQ
秚	banHQ
板	banI
柈	banIQ
钣	banJ
鈑	banJQ
鉡	banJS
褩	banKQ
办	banL
朌	banLQ
肦	banLS
粄	banMQ
闆	banMS
姅	banNQ
鳻	banNS
版	banP
妭	baNQ
昄	banRQ
岅	banSQ
坂	banT
坢	banTQ
伴	banV
班	banW
斑	banWP
攽	banWQ
斒	banWS
瓪	banWT
辦	banXQ
怑	banXS
辬	banXT
颁	banY
頒	banYQ
魬	banYS
般	banZ
舨	banZP
跘	banZQ
吧	baO
报	baoA
抱	baoAP
包	baoB
龅	baoBC
勹	baoBD
宝	baoBP
寶	baoBQ
勽	baoBS
宲	baoBT
寚	baoBU
寳	baoBV
賲	baoBW
髱	baoBX
忁	baoCQ
蚫	baoCS
齙	baoCT
剥	baoD
剝	baoDQ
瀑	baoE
緥	baoFQ
骲	baoGQ
炮	baoH
煲	baoHC
爆	baoHP
虣	baoHQ
枹	baoIQ
鉋	baoJQ
鑤	baoJS
铇	baoJT
褒	baoK
褓	baoKP
笣	baoKQ
袌	baoKS
裦	baoKT
襃	baoKU
胞	baoL
闁	baoMQ
駂	baoMS
鸨	baoN
媬	baoNQ
犦	baoNS
鳵	baoNT
鴇	baoNU
嚗	baoOQ
叭	baOP
哱	baOQ
犳	baoQQ
暴	baoR
曝	baoRC
雹	baoRP
曓	baoRQ
靌	baoRS
饱	baoS
飽	baoSQ
飹	baoSS
堡	baoT
報	baoTQ
堢	baoTS
薄	baoU
葆	baoUC
苞	baoUP
菢	baoUQ
蕔	baoUS
藵	baoUT
保	baoV
佨	baoVQ
儤	baoVS
哵	baOW
珤	baoWQ
怉	baoXQ
窇	baoXS
鲍	baoY
鮑	baoYQ
孢	baoZ
趵	baoZC
豹	baoZP
豝	baQQ
霸	baR
罢	baS
岜	baSP
峇	baSQ
矲	baSS
罷	baST
鼥	baSU
坝	baT
壩	baTQ
垻	baTS
芭	baU
茇	baUC
菝	baUP
仈	baVQ
玐	baWQ
覇	baXQ
鲅	baY
叐	baYQ
犮	baYS
羓	baYT
詙	baYU
鮁	baYV
鮊	baYW
鲃	baYX
鲌	baYY
魞	baYZ
跋	baZ
跁	baZQ
毕	beB
庇	beG
揹	beiAQ
北	beiB
贝	beiBP
貝	beiBQ
辈	beiC
輩	beiCQ
蛽	beiCS
軰	beiCT
陂	beiF
邶	beiFP
郥	beiFQ
鄁	beiFS
鞴	beiG
鞁	beiGQ
鞞	beiGS
骳	beiGT
焙	beiH
杯	beiI
杮	beiIQ
柸	beiIS
桮	beiIT
梖	beiIU
棑	beiIV
棓	beiIW
椑	beiIX
钡	beiJ
鐾	beiJP
鉳	beiJQ
鋇	beiJS
被	beiK
褙	beiKP
箄	beiKQ
背	beiL
盃	beiMQ
糒	beiMS
鹎	beiN
牬	beiNQ
犕	beiNS
鵯	beiNT
呗	beiO
唄	beiOQ
碑	beiP
碚	beiPP
狈	beiQ
狽	beiQQ
昁	beiRQ
卑	beiS
孛	beiSP
禙	beiSQ
蓓	beiU
苝	beiUQ
藣	beiUS
倍	beiV
備	beiVQ
俻	beiVS
偝	beiVT
偹	beiVU
僃	beiVV
珼	beiWQ
琲	beiWS
悲	beiX
悖	beiXC
惫	beiXP
憊	beiXQ
愂	beiXS
誖	beiYQ
諀	beiYS
备	beiZ
捹	benAQ
撪	benAS
賁	benBQ
蟦	benCQ
奔	benD
夯	benDP
夲	benDQ
奙	benDS
泍	benEQ
渀	benES
漰	benET
揼	bengAQ
痭	bengBQ
蚌	bengC
蜯	bengCQ
奟	bengDQ
泵	bengE
绷	bengF
綳	bengFQ
絣	bengFS
繃	bengFT
鞛	bengGQ
鏰	bengJQ
镚	bengJS
閍	bengMQ
嘣	bengO
嗙	bengOQ
體	benGQ
崩	bengS
嵭	bengSQ
祊	bengSS
埄	bengTQ
埲	bengTS
塴	bengTT
菶	bengUQ
伻	bengVQ
甏	bengW
琣	bengWQ
琫	bengWS
甭	bengY
甮	bengYQ
蹦	bengZ
迸	bengZP
跰	bengZQ
逬	bengZS
炃	benHQ
本	benI
栟	benIQ
桳	benIS
楍	benIT
锛	benJ
錛	benJQ
笨	benK
犇	benNQ
喯	benOQ
畚	benS
坌	benT
坋	benTQ
苯	benU
倴	benVQ
翉	benYQ
逩	benZQ
跛	beZ
抃	bianAQ
揙	bianAS
贬	bianB
貶	bianBQ
疺	bianBS
蝙	bianC
徧	bianCQ
釆	bianCS
卞	bianD
汴	bianE
汳	bianEQ
编	bianF
缏	bianFC
匾	bianFP
編	bianFQ
緶	bianFS
鞭	bianG
鞕	bianGQ
扁	bianH
煸	bianHP
炞	bianHQ
稨	bianHS
覍	bianJQ
覵	bianJS
鍽	bianJT
笾	bianK
褊	bianKP
箯	bianKQ
籓	bianKS
籩	bianKT
糄	bianMQ
閞	bianMS
鴘	bianNQ
鶣	bianNS
砭	bianP
碥	bianPP
牑	bianPQ
猵	bianQQ
獱	bianQS
昪	bianRQ
弁	bianS
峅	bianSQ
苄	bianU
萹	bianUQ
藊	bianUS
便	bianV
玣	bianWQ
甂	bianWS
辩	bianX
辫	bianXC
窆	bianXD
忭	bianXE
辨	bianXP
辮	bianXQ
辯	bianXS
惼	bianXT
辡	bianXU
辧	bianXV
变	bianY
鳊	bianYP
變	bianYQ
諚	bianYS
鯾	bianYT
鯿	bianYU
边	bianZ
遍	bianZP
邊	bianZQ
変	bianZS
臱	bianZT
艑	bianZU
辺	bianZV
邉	bianZW
摽	biaoAQ
瘭	biaoB
贆	biaoBQ
髟	biaoBS
淲	biaoEQ
滮	biaoES
瀌	biaoET
飚	biaoF
飑	biaoFC
飙	biaoFP
颩	biaoFQ
颮	biaoFS
颷	biaoFT
飆	biaoFU
飇	biaoFV
飈	biaoFW
飊	biaoFX
熛	biaoHQ
爂	biaoHS
穮	biaoHT
灬	biaoHU
标	biaoI
標	biaoIQ
檦	biaoIS
镖	biaoJ
镳	biaoJP
幖	biaoJQ
鋲	biaoJS
錶	biaoJT
鏢	biaoJU
鑣	biaoJV
表	biaoK
裱	biaoKP
篻	biaoKQ
褾	biaoKS
膘	biaoL
脿	biaoLQ
膔	biaoLS
臕	biaoLT
麃	biaoLU
骠	biaoM
驃	biaoMQ
驫	biaoMS
骉	biaoMT
婊	biaoN
嫑	biaoNQ
磦	biaoPQ
猋	biaoQQ
彪	biaoS
墂	biaoTQ
蔈	biaoUQ
藨	biaoUS
俵	biaoVQ
僄	biaoVS
儦	biaoVT
鳔	biaoY
諘	biaoYQ
謤	biaoYS
鰾	biaoYT
比	biB
鼻	biBC
毙	biBD
痹	biBE
匕	biBF
贲	biBG
毖	biBH
贔	biBO
毕	biBP
髲	biBQ
赑	biBS
疕	biBT
疪	biBU
痺	biBV
皀	biBW
皕	biBX
貱	biBY
賁	biBZ
彼	biC
蜌	biCQ
螕	biCS
夶	biDQ
奰	biDS
豍	biDT
濞	biE
瘪	bieB
癟	bieBQ
徶	bieCQ
蛂	bieCS
蟞	bieCT
别	bieD
別	bieDQ
彆	bieGQ
龞	bieGS
柭	bieIQ
柲	bieIS
襒	bieKQ
鼈	bieMQ
滗	biEP
沘	biEQ
湢	biES
滭	biET
潷	biEU
莂	bieUQ
虌	bieUS
憋	bieX
鳖	bieY
鱉	bieYQ
蹩	bieZ
鄙	biF
邲	biFO
陛	biFP
鄪	biFQ
鄨	biFS
旇	biFT
紕	biFU
紴	biFV
綼	biFW
縪	biFX
繴	biFY
聛	biFZ
弊	biG
庇	biGC
髀	biGD
庳	biGE
弼	biGP
廦	biGQ
弻	biGS
彃	biGT
鞞	biGU
鞸	biGV
魓	biGW
秕	biH
煏	biHQ
熚	biHS
稫	biHT
朼	biIQ
柀	biIS
柲	biIT
梐	biIU
楅	biIV
榌	biIW
币	biJ
铋	biJP
幣	biJQ
幤	biJS
觱	biJT
鉍	biJU
鎞	biJV
鏎	biJW
鐴	biJX
笔	biK
襞	biKC
篦	biKD
筚	biKE
箅	biKF
裨	biKP
筆	biKQ
笓	biKS
箄	biKT
箆	biKU
篳	biKV
袐	biKW
襣	biKX
襅	biKY
臂	biL
肶	biLQ
胇	biLS
腷	biLT
闭	biM
閈	biML
閇	biMM
粊	biMN
粃	biMO
睥	biMP
閉	biMQ
鼊	biMS
驆	biMT
駜	biMU
闬	biMV
閟	biMW
毞	biMX
毴	biMY
睤	biMZ
婢	biN
摈	binA
擯	binAQ
宾	binB
鬓	binBP
賓	binBQ
鬢	binBS
賔	binBT
髩	binBU
鬂	binBV
嬖	biNC
蠙	binCQ
殡	binD
殯	binDQ
滨	binE
濒	binEP
濱	binEQ
瀕	binES
汃	binET
濵	binEU
缤	binF
繽	binFQ
邠	binFS
髌	binG
摒	bingA
抦	bingAQ
掤	bingAS
并	bingB
兵	bingBC
冰	bingBD
病	bingBP
並	bingBQ
寎	bingBS
冫	bingBT
蛃	bingCQ
氷	bingEQ
邴	bingF
絣	bingFQ
綆	bingFS
陃	bingFT
幷	bingGQ
庰	bingGS
鞆	bingGT
鞞	bingGU
鞸	bingGV
丙	bingH
秉	bingHC
炳	bingHP
稟	bingHQ
柄	bingI
槟	bingIP
栟	bingIQ
栤	bingIS
梹	bingIT
棅	bingIU
檳	bingIV
鈵	bingJQ
鉼	bingJS
竝	bingLQ
眪	bingMQ
屏	bingP
屛	bingPQ
髕	binGQ
昞	bingRQ
昺	bingRS
靐	bingRT
饼	bingS
禀	bingSP
餅	bingSQ
餠	bingSS
垪	bingTQ
苪	bingUQ
仌	bingVQ
併	bingVS
倂	bingVT
偋	bingVU
傡	bingVV
仒	bingVW
琕	bingWQ
怲	bingXQ
窉	bingXS
誁	bingYQ
鮩	bingYS
虨	binHQ
槟	binI
梹	binIQ
椕	binIS
檳	binIT
镔	binJ
鑌	binJQ
膑	binL
臏	binLQ
妣	biNP
砏	binPQ
妼	biNQ
豩	binQQ
霦	binRQ
彬	binS
豳	binSP
鵖	biNT
鶝	biNU
鷝	biNV
儐	binVQ
傧	binVR
斌	binW
玢	binWP
瑸	binWQ
璸	binWS
嬶	biNX
娝	biNY
頻	binYQ
顮	binYS
鷩	biNZ
吡	biO
哔	biOP
咇	biOQ
啚	biOS
嗶	biOT
碧	biP
屄	biPQ
狴	biQ
獘	biQQ
獙	biQS
朇	biRQ
崥	biSQ
祕	biSS
禆	biST
罼	biSU
飶	biSV
饆	biSW
壁	biT
畀	biTP
畢	biTQ
坒	biTS
堛	biTT
畁	biTU
畐	biTV
蔽	biU
蓖	biUC
芘	biUD
荜	biUE
薜	biUF
萆	biUG
荸	biUP
苾	biUQ
萞	biUS
蓽	biUT
俾	biV
佊	biVQ
佖	biVS
偪	biVT
璧	biW
敝	biWP
斃	biWQ
珌	biWS
韠	biWT
必	biX
愎	biXC
辟	biXP
怭	biXQ
怶	biXS
愊	biXT
馝	biXU
翍	biYQ
詖	biYS
诐	biYT
鮅	biYU
鰏	biYV
鲾	biYW
避	biZ
舭	biZC
跸	biZD
逼	biZP
貏	biZQ
蹕	biZS
躃	biZT
躄	biZU
迊	biZV
播	boA
搏	boAC
擘	boAD
拨	boAP
撥	boAQ
挬	boAS
卜	boB
癶	boBQ
皪	boBS
彴	boCQ
蚾	boCS
剥	boD
剝	boDQ
殕	boDS
波	boE
渤	boEC
泊	boEP
浡	boEQ
淿	boES
溊	boET
紴	boFQ
缽	boFS
郣	boFT
瓝	boGQ
瓟	boGS
髆	boGT
髉	boGU
煿	boHQ
秡	boHS
穛	boHT
柏	boI
檗	boIP
柭	boIQ
栢	boIS
桲	boIT
榑	boIU
檘	boIV
欂	boIW
钵	boJ
帛	boJC
钹	boJD
铂	boJP
鈸	boJQ
鉑	boJS
鉢	boJT
鋍	boJU
鎛	boJV
鑮	boJW
镈	boJX
簸	boK
簙	boKQ
袯	boKS
袹	boKT
襏	boKU
襮	boKV
勃	boL
膊	boLC
脖	boLP
肑	boLQ
胉	boLS
驳	boM
駁	boMQ
盋	boMS
糪	boMT
駮	boMU
驋	boMV
鹁	boN
鵓	boNQ
啵	boO
哱	boOQ
噃	boOS
嚗	boOT
礴	boP
牔	boPQ
砵	boPS
碆	boPT
磻	boPU
礡	boPV
狛	boQQ
猼	boQS
博	boS
饽	boSP
嶓	boSQ
餑	boSS
餺	boST
馎	boSU
亳	boT
壆	boTQ
薄	boU
菠	boUP
苩	boUQ
萡	boUS
葧	boUT
蔔	boUU
蘗	boUV
伯	boV
仢	boVQ
侼	boVS
僠	boVT
僰	boVU
玻	boW
愽	boXQ
懪	boXS
馛	boXT
馞	boXU
誖	boYQ
謈	boYS
譒	boYT
鮊	boYU
鱍	boYV
鲌	boYW
舶	boZ
跛	boZC
踣	boZD
箔	boZP
孹	boZQ
艊	boZS
蹳	boZT
捕	buA
抪	buAQ
捗	buAS
捬	buAT
卜	buB
轐	buCQ
部	buF
巭	buFQ
郶	buFS
庯	buGQ
廍	buGS
不	buH
柨	buIQ
布	buJ
钸	buJC
钚	buJP
鈈	buJQ
鈽	buJS
錻	buJT
补	buK
簿	buKP
補	buKQ
箁	buKS
篰	buKT
勏	buLQ
兺	bunBQ
婄	buNQ
鳪	buNS
鵏	buNT
鸔	buNU
哺	buO
卟	buOP
吥	buOQ
咘	buOS
醭	buQ
晡	buR
峬	buSQ
餔	buSS
餢	buST
埔	buT
埠	buTP
埗	buTQ
荹	buUQ
蔀	buUS
蔔	buUT
佈	buVQ
瓿	buW
怖	buX
悑	buXQ
誧	buYQ
鯆	buYS
步	buZ
逋	buZP
歨	buZQ
歩	buZS
踄	buZT
擦	caA
攃	caAQ
才	caiA
採	caiAQ
扐	caiAS
揌	caiAT
财	caiB
財	caiBQ
宷	caiBS
寀	caiBT
采	caiC
綵	caiFQ
縩	caiFS
纔	caiFT
材	caiI
棌	caiIQ
裁	caiK
睬	caiM
婇	caiNQ
啋	caiOQ
猜	caiQ
彩	caiS
埰	caiTQ
菜	caiU
蔡	caiUP
倸	caiVQ
偲	caiVS
踩	caiZ
跴	caiZQ
摲	canAQ
摻	canAS
蚕	canC
蠶	canCQ
蝅	canCS
蠺	canCT
残	canD
殘	canDQ
湌	canEQ
澯	canES
凔	cangBQ
賶	cangBS
螥	cangCQ
沧	cangE
滄	cangEQ
濸	cangES
匨	cangFQ
鑶	cangJQ
篬	cangKQ
鶬	cangNQ
鸧	cangNS
獊	cangQQ
嵢	cangSQ
藏	cangU
苍	cangUP
蒼	cangUQ
仓	cangV
伧	cangVP
倉	cangVQ
仺	cangVS
傖	cangVT
玱	cangWQ
瑲	cangWS
舱	cangZ
艙	cangZQ
灿	canH
黪	canHP
燦	canHQ
爘	canHS
穇	canHT
黲	canHU
鏒	canJQ
篸	canKQ
粲	canM
骖	canMP
驂	canMQ
嬠	canNQ
喰	canOQ
嘇	canOS
囋	canOT
孱	canP
朁	canRQ
参	canS
餐	canSP
參	canSQ
叄	canSS
叅	canST
飡	canSU
飱	canSV
薒	canUQ
傪	canVQ
儏	canVS
璨	canW
惨	canX
惭	canXP
慘	canXQ
慚	canXS
慙	canXT
憯	canXU
謲	canYQ
嚓	caO
操	caoA
撡	caoAU
螬	caoC
屮	caoCT
漕	caoE
鄵	caoFS
鼜	caoGQ
槽	caoI
鏪	caoJS
褿	caoKS
襙	caoKT
肏	caoLQ
糙	caoM
騲	caoMS
嘈	caoO
囃	caOQ
曹	caoR
曺	caoRQ
嶆	caoST
草	caoU
艸	caoUQ
蓸	caoUT
艹	caoUV
傮	caoVQ
愺	caoXQ
慅	caoXS
慒	caoXT
懆	caoXV
艚	caoZ
礤	caP
礸	caPQ
遪	caZQ
拺	ceAQ
厕	ceC
厠	ceCQ
夨	ceDQ
测	ceE
測	ceEQ
廁	ceGQ
策	ceK
笧	ceKQ
筞	ceKS
筴	ceKT
箣	ceKU
簎	ceKV
粣	ceMQ
涔	cenE
汵	cenEQ
橧	cengIQ
竲	cengLQ
驓	cengMQ
噌	cengO
层	cengP
層	cengPQ
曾	cengR
曽	cengRQ
嶒	cengSQ
蹭	cengZ
穇	cenHQ
梣	cenIQ
笒	cenKQ
篸	cenKS
参	cenS
岑	cenSP
參	cenSQ
叄	cenSS
叅	cenST
嵾	cenSU
埁	cenTQ
册	ceP
冊	ceTQ
畟	ceTS
荝	ceUQ
萗	ceUS
萴	ceUT
蓛	ceUU
侧	ceV
側	ceVQ
敇	ceWQ
恻	ceX
惻	ceXQ
憡	ceXS
插	chaA
搽	chaAP
扠	chaAQ
扱	chaAS
挿	chaAT
捈	chaAU
揷	chaAV
摖	chaAW
察	chaB
刹	chaD
剎	chaDQ
汊	chaE
紁	chaFQ
差	chaG
靫	chaGQ
秅	chaHQ
查	chaI
拆	chaiA
瘥	chaiB
杈	chaIC
蠆	chaiCQ
虿	chaiCR
槎	chaID
檫	chaIE
差	chaiG
柴	chaiI
钗	chaiJ
釵	chaiJQ
袃	chaiKQ
肞	chaiLQ
喍	chaiOQ
囆	chaiOS
楂	chaIP
査	chaIQ
犲	chaiQQ
梌	chaIS
祡	chaiSQ
芆	chaiUQ
茝	chaiUS
侪	chaiV
儕	chaiVQ
訍	chaiYQ
豺	chaiZ
锸	chaJ
镲	chaJP
臿	chaJQ
銟	chaJS
鍤	chaJT
鎈	chaJU
鑔	chaJV
衩	chaK
姹	chaN
掺	chanA
搀	chanAP
攙	chanAQ
摌	chanAS
摲	chanAT
摻	chanAU
冁	chanB
毚	chanBQ
蝉	chanC
蟾	chanCP
蟬	chanCQ
螹	chanCS
刬	chanDQ
剗	chanDS
剷	chanDT
劖	chanDU
潺	chanE
澶	chanEP
浐	chanEQ
湹	chanES
滻	chanET
潹	chanEU
瀍	chanEV
瀺	chanEW
灛	chanEX
缠	chanF
纏	chanFQ
酁	chanFS
斺	chanFT
緂	chanFU
緾	chanFV
繟	chanFW
繵	chanFX
纒	chanFY
鄽	chanFZ
廛	chanG
鬯	changB
長	changBQ
镸	changBS
长	changC
徜	changCC
厂	changCP
厰	changCQ
蟐	changCS
兏	changEQ
淐	changES
廠	changGQ
甞	changGS
鼚	changGT
焻	changHQ
椙	changIQ
常	changJ
鋹	changJQ
錩	changJS
锠	changJT
裳	changK
裮	changKQ
肠	changL
腸	changLQ
膓	changLS
氅	changM
阊	changMP
閶	changMQ
闛	changMS
嫦	changN
娼	changNP
唱	changO
嘗	changOQ
嚐	changOS
猖	changQ
韂	chanGQR
昌	changR
昶	changRP
暢	changRQ
场	changT
畅	changTP
場	changTQ
塲	changTS
畼	changTT
菖	changU
苌	changUP
萇	changUQ
偿	changV
伥	changVC
倡	changVP
償	changVQ
仧	changVS
仩	changVT
倀	changVU
僘	changVV
敞	changW
玚	changWQ
琩	changWS
瑒	changWT
瑺	changWU
瓺	changWV
韔	changWW
尝	changX
惝	changXC
怅	changXP
悵	changXQ
鲳	changY
誯	changYQ
鯧	changYS
鱨	changYT
鲿	changYU
煘	chanHQ
燀	chanHS
梴	chanIQ
棎	chanIS
欃	chanIT
铲	chanJ
觇	chanJP
鏟	chanJQ
幝	chanJS
幨	chanJT
覘	chanJU
鋋	chanJV
鋓	chanJW
鑱	chanJX
镵	chanJY
簅	chanKQ
裧	chanKS
襜	chanKT
丳	chanLQ
阐	chanM
骣	chanMP
闡	chanMQ
閳	chanMS
驏	chanMT
婵	chanN
嬋	chanNQ
單	chanOQ
啴	chanOS
嘽	chanOT
嚵	chanOU
囅	chanOV
孱	chanP
羼	chanPP
硟	chanPQ
磛	chanPS
奼	chaNQ
獑	chanQQ
醦	chanQS
旵	chanRQ
禅	chanS
馋	chanSP
嶄	chanSQ
產	chanSS
禪	chanST
饞	chanSU
嶃	chanSV
巉	chanSW
産	chanSX
产	chanT
壥	chanTQ
蒇	chanU
苂	chanUQ
蕆	chanUS
僝	chanVQ
儃	chanVS
儳	chanVT
忏	chanX
懴	chanXQ
懺	chanXS
颤	chanY
谗	chanYC
谄	chanYP
顫	chanYQ
誗	chanYS
諂	chanYT
譂	chanYU
讇	chanYV
讒	chanYW
躔	chanZ
艬	chanZQ
辿	chanZS
喳	chaO
抄	chaoA
摷	chaoAQ
巢	chaoC
巣	chaoCQ
轈	chaoCS
剿	chaoD
劋	chaoDQ
潮	chaoE
漅	chaoEQ
绰	chaoF
綽	chaoFQ
鄛	chaoFS
弨	chaoGQ
炒	chaoH
焯	chaoHP
焣	chaoHQ
煼	chaoHS
槱	chaoIQ
樔	chaoIS
钞	chaoJ
鈔	chaoJQ
觘	chaoJS
朝	chaoL
耖	chaoLP
勦	chaoLQ
眧	chaoMQ
粆	chaoMS
麨	chaoMT
鼂	chaoMU
鼌	chaoMV
吵	chaoO
嘲	chaoOP
牊	chaoPQ
嚓	chaOPR
嗏	chaOQ
欩	chaoQQ
晁	chaoR
巐	chaoSQ
禉	chaoSS
罺	chaoST
仦	chaoVQ
仯	chaoVS
怊	chaoX
窲	chaoXQ
窼	chaoXS
訬	chaoYQ
謿	chaoYS
超	chaoZ
碴	chaP
猹	chaQ
岔	chaS
馇	chaSP
嵖	chaSQ
餷	chaSS
垞	chaTQ
疀	chaTS
茶	chaU
茬	chaUP
芆	chaUQ
仛	chaVQ
侘	chaVS
偛	chaVT
叉	chaY
诧	chaYP
詧	chaYQ
詫	chaYS
艖	chaZQ
蹅	chaZS
撤	cheA
掣	cheAC
扯	cheAP
揊	cheAQ
摰	cheAS
撦	cheAT
车	cheC
彻	cheCP
徹	cheCQ
車	cheCS
蛼	cheCT
奲	cheDQ
澈	cheE
聅	cheFQ
烢	cheHQ
烲	cheHS
焎	cheHT
爡	cheHU
勶	cheLQ
瞮	cheMQ
抻	chenA
捵	chenAQ
宸	chenB
疢	chenBQ
瘎	chenBS
瘨	chenBT
賝	chenBU
贂	chenBV
臣	chenC
龀	chenCC
辰	chenCP
螴	chenCQ
軙	chenCS
齓	chenCT
齔	chenCU
沉	chenE
沈	chenEP
陈	chenF
郴	chenFP
陳	chenFQ
綝	chenFS
承	chengA
撑	chengAP
搶	chengAQ
撐	chengAS
挰	chengAT
掁	chengAU
揨	chengAV
摚	chengAW
撜	chengAX
凈	chengBQ
宬	chengBS
蛏	chengC
徎	chengCQ
蟶	chengCS
赪	chengCT
赬	chengCU
澄	chengE
瀓	chengEQ
氶	chengES
泟	chengET
洆	chengEU
浧	chengEV
浾	chengEW
淨	chengEX
溗	chengEY
澂	chengEZ
絾	chengFQ
緽	chengFS
罉	chengFT
郕	chengFU
阷	chengFV
成	chengG
庱	chengGQ
程	chengH
秤	chengHC
丞	chengHD
称	chengHP
稱	chengHQ
穪	chengHS
橙	chengI
枨	chengIC
柽	chengIP
朾	chengIQ
棖	chengIS
棦	chengIT
椉	chengIU
橕	chengIV
橖	chengIW
檉	chengIX
檙	chengIY
铛	chengJ
铖	chengJP
鐺	chengJQ
鋮	chengJS
鎗	chengJT
鏿	chengJU
鐣	chengJV
裎	chengK
筬	chengKQ
塍	chengL
脭	chengLQ
骋	chengM
瞠	chengMP
睈	chengMQ
矃	chengMS
騁	chengMT
騬	chengMU
娍	chengNQ
呈	chengO
乘	chengP
乗	chengPQ
碀	chengPS
酲	chengQ
靗	chengQQ
晿	chengRQ
峸	chengSQ
饓	chengSS
城	chengT
埕	chengTP
埩	chengTQ
堘	chengTS
塖	chengTT
畻	chengTU
荿	chengUQ
侱	chengVQ
偁	chengVS
僜	chengVT
珵	chengWQ
珹	chengWS
琤	chengWT
惩	chengX
懲	chengXQ
悜	chengXS
憆	chengXT
憕	chengXU
窚	chengXV
竀	chengXW
诚	chengY
誠	chengYQ
牚	chengYS
頳	chengYT
鯎	chengYU
逞	chengZ
爯	chengZQ
称	chenH
烥	chenHQ
煁	chenHS
稱	chenHT
穪	chenHU
榇	chenI
栕	chenIQ
桭	chenIS
梣	chenIT
棽	chenIU
樄	chenIV
櫬	chenIW
鈂	chenJQ
鍖	chenJS
衬	chenK
襯	chenKQ
麎	chenLQ
瞋	chenMQ
鷐	chenNQ
嗔	chenO
嚫	chenOQ
碜	chenP
硶	chenPQ
磣	chenPS
醦	chenQQ
晨	chenR
曟	chenRQ
霃	chenRS
塵	chenTQ
墋	chenTS
茞	chenUQ
莀	chenUS
莐	chenUT
蔯	chenUU
薼	chenUV
偁	chenVQ
傖	chenVS
儭	chenVT
琛	chenW
敐	chenWQ
敶	chenWS
尘	chenX
忱	chenXP
夦	chenXQ
愖	chenXS
谶	chenY
谌	chenYP
訦	chenYQ
諃	chenYS
諶	chenYT
謓	chenYU
讖	chenYV
趁	chenZ
爯	chenZQ
趂	chenZS
趻	chenZT
跈	chenZU
踸	chenZV
迧	chenZW
呫	cheOQ
唓	cheOS
砗	cheP
硨	chePQ
硩	chePS
坼	cheT
莗	cheUQ
屮	cheUS
伡	cheVQ
俥	cheVS
偖	cheVT
頙	cheYQ
迠	cheZQ
持	chiA
扡	chiAQ
抶	chiAS
拸	chiAT
捇	chiAU
摛	chiAV
攡	chiAW
痴	chiB
瘛	chiBC
匙	chiBP
痸	chiBQ
瘈	chiBS
癡	chiBT
貾	chiBU
赤	chiC
蚩	chiCC
螭	chiCD
彳	chiCE
齿	chiCP
齒	chiCQ
徲	chiCS
蚇	chiCT
蚳	chiCU
齝	chiCV
豉	chiD
奓	chiDQ
殦	chiDS
池	chiE
沶	chiEQ
湁	chiES
漦	chiET
耻	chiF
絺	chiFQ
弛	chiG
魑	chiGP
炽	chiH
灻	chiHQ
烾	chiHS
熾	chiHT
杘	chiIQ
柅	chiIS
樆	chiIT
斥	chiJ
卶	chiJQ
鉓	chiJS
鉹	chiJT
銐	chiJU
鍉	chiJV
笞	chiK
篪	chiKC
褫	chiKP
竾	chiKQ
筂	chiKS
箈	chiKT
箎	chiKU
袲	chiKV
袳	chiKW
裭	chiKX
勅	chiLQ
勑	chiLS
耛	chiLT
肔	chiLU
胣	chiLV
胵	chiLW
腟	chiLX
驰	chiM
眵	chiMP
馳	chiMQ
瞝	chiMS
粚	chiMT
麶	chiMU
鸱	chiN
媸	chiNC
妛	chiNQ
鴟	chiNS
鵄	chiNT
鶒	chiNU
鶗	chiNV
鶙	chiNW
鷘	chiNX
吃	chiO
嗤	chiOC
叱	chiOD
啻	chiOE
哧	chiOP
叺	chiOQ
呎	chiOS
喫	chiOT
噄	chiOU
噭	chiOV
尺	chiP
硳	chiPQ
欼	chiQQ
狋	chiQS
雴	chiRQ
饬	chiS
彨	chiSQ
彲	chiSS
飭	chiST
黐	chiSU
墀	chiT
垑	chiTQ
茌	chiU
荎	chiUQ
菭	chiUS
侈	chiV
傺	chiVP
伬	chiVQ
佁	chiVS
侙	chiVT
俿	chiVU
敕	chiW
瓻	chiWQ
恥	chiXQ
恜	chiXS
慗	chiXT
慸	chiXU
憏	chiXV
懘	chiXW
翅	chiY
翄	chiYQ
翤	chiYS
翨	chiYT
訵	chiYU
誃	chiYV
誺	chiYW
謘	chiYX
迟	chiZ
遟	chiZN
遅	chiZO
踟	chiZP
遲	chiZQ
邌	chiZS
遫	chiZT
歭	chiZU
歯	chiZV
赿	chiZW
趩	chiZX
跢	chiZY
迡	chiZZ
揰	chongAQ
摏	chongAS
冲	chongB
宠	chongBP
寵	chongBQ
痋	chongBS
虫	chongC
蟲	chongCQ
徸	chongCS
蝩	chongCT
沖	chongEQ
浺	chongES
漴	chongET
緟	chongFQ
隀	chongFS
爞	chongHQ
舂	chongJ
铳	chongJP
銃	chongJQ
褈	chongKQ
嘃	chongOQ
重	chongP
崇	chongS
崈	chongSQ
罿	chongSS
充	chongT
埫	chongTQ
茺	chongU
珫	chongWQ
憧	chongX
忡	chongXP
憃	chongXQ
衝	chongXS
翀	chongYQ
艟	chongZ
蹖	chongZQ
抽	chouA
掫	chouAQ
搊	chouAS
瘳	chouB
皗	chouBQ
殠	chouDQ
绸	chouF
綢	chouFQ
紬	chouFS
絒	chouFT
魗	chouGQ
稠	chouH
丒	chouHQ
燽	chouHS
杻	chouIQ
杽	chouIS
栦	chouIT
梼	chouIU
椆	chouIV
檮	chouIW
帱	chouJ
幬	chouJQ
筹	chouK
籌	chouKQ
篘	chouKS
裯	chouKT
瞅	chouM
盩	chouMQ
矁	chouMS
婤	chouNQ
嬦	chouNS
牰	chouNT
犨	chouNU
犫	chouNV
吜	chouOQ
嚋	chouOS
酬	chouQ
醜	chouQQ
酧	chouQS
醔	chouQT
醻	chouQU
畴	chouT
疇	chouTQ
畤	chouTS
菗	chouUQ
薵	chouUS
仇	chouV
俦	chouVC
丑	chouVP
偢	chouVQ
儔	chouVS
愁	chouX
惆	chouXP
怞	chouXQ
懤	chouXS
詶	chouYQ
譸	chouYS
讎	chouYT
讐	chouYU
诪	chouYV
鮘	chouYW
臭	chouZ
雠	chouZC
踌	chouZP
臰	chouZQ
跾	chouZS
躊	chouZT
遚	chouZU
雔	chouZV
雦	chouZW
搐	chuA
揣	chuaiA
搋	chuaiAP
膪	chuaiL
膗	chuaiLQ
啜	chuaiO
嘬	chuaiOP
欼	chuaiQQ
踹	chuaiZ
賗	chuanBQ
川	chuanC
輲	chuanCQ
巛	chuanCS
剶	chuanDQ
汌	chuanEQ
摐	chuangAQ
疮	chuangB
瘡	chuangBQ
创	chuangD
創	chuangDQ
刅	chuangDS
刱	chuangDT
剏	chuangDU
剙	chuangDV
床	chuangG
橦	chuangIQ
幢	chuangJ
朣	chuangLQ
闯	chuangM
闖	chuangMQ
喠	chuangOQ
噇	chuangOS
牀	chuangPQ
牎	chuangPS
牕	chuangPT
磢	chuangPU
傸	chuangVQ
窗	chuangX
怆	chuangXP
愴	chuangXQ
窓	chuangXS
窻	chuangXT
椽	chuanI
椯	chuanIQ
钏	chuanJ
釧	chuanJQ
篅	chuanKQ
串	chuanL
膞	chuanLQ
鶨	chuanNQ
喘	chuanO
氚	chuanQ
歂	chuanQQ
猭	chuanQS
暷	chuanRQ
堾	chuanTQ
荈	chuanUQ
传	chuanV
傳	chuanVQ
僢	chuanVS
圌	chuanWQ
玔	chuanWS
瑏	chuanWT
穿	chuanX
舛	chuanXP
船	chuanZ
遄	chuanZC
舡	chuanZP
舩	chuanZQ
踳	chuanZS
摢	chuAQ
欻	chuaQQ
摴	chuAS
厨	chuC
蜍	chuCP
蟵	chuCQ
齣	chuCS
齭	chuCT
齼	chuCU
初	chuD
刍	chuDP
滁	chuE
泏	chuEQ
滀	chuES
濋	chuET
除	chuF
绌	chuFP
絀	chuFQ
鄐	chuFS
廚	chuGQ
黜	chuH
亍	chuHP
處	chuHQ
炪	chuHS
楚	chuI
捶	chuiA
搥	chuiAQ
杵	chuIC
樗	chuID
楮	chuIE
陲	chuiF
炊	chuiH
椎	chuiI
棰	chuiIC
槌	chuiIP
桘	chuiIQ
锤	chuiJ
錘	chuiJQ
鎚	chuiJS
箠	chuiKQ
腄	chuiLQ
吹	chuiO
橱	chuIP
硾	chuiPQ
櫥	chuIQ
椘	chuIS
垂	chuiT
埀	chuiTQ
榋	chuITR
橻	chuIU
菙	chuiUQ
檚	chuIV
倕	chuiVQ
櫉	chuIW
圌	chuiWQ
櫖	chuIX
惙	chuiXQ
顀	chuiYQ
龡	chuiYS
触	chuJ
锄	chuJP
觸	chuJQ
鋤	chuJS
処	chuJT
幮	chuJU
斶	chuJV
鉏	chuJW
出	chuK
褚	chuKP
篨	chuKQ
竌	chuLQ
竐	chuLS
耝	chuLT
耡	chuLU
臅	chuLV
閦	chuMQ
賰	chunBQ
蠢	chunC
蝽	chunCP
輴	chunCQ
淳	chunE
浱	chunEQ
湻	chunES
滣	chunET
漘	chunEU
纯	chunF
純	chunFQ
陙	chunFS
椿	chunI
杶	chunIQ
槆	chunIS
橁	chunIT
櫄	chunIU
錞	chunJQ
箺	chunKQ
脣	chunLQ
膞	chunLS
睶	chunMQ
鹑	chunN
媋	chunNQ
犉	chunNS
鶉	chunNT
鶞	chunNU
唇	chunO
醇	chunQ
醕	chunQQ
媰	chuNQR
春	chunR
旾	chunRQ
暙	chunRS
犓	chuNS
鶵	chuNT
堾	chunTQ
莼	chunU
芚	chunUQ
萅	chunUS
萶	chunUT
蒓	chunUU
蓴	chunUV
偆	chunVQ
瑃	chunWQ
惷	chunXQ
鯙	chunYQ
鰆	chunYS
拺	chuoAQ
擉	chuoAS
辍	chuoC
龊	chuoCP
輟	chuoCQ
齪	chuoCS
涰	chuoEQ
绰	chuoF
綽	chuoFQ
繛	chuoFS
戳	chuoG
鋜	chuoJQ
鏃	chuoJS
鑡	chuoJT
箹	chuoKQ
娕	chuoNQ
娖	chuoNS
婥	chuoNT
婼	chuoNU
孎	chuoNV
啜	chuoO
吷	chuoOQ
哾	chuoOS
嚽	chuoOT
磭	chuoPQ
嘼	chuOQ
歠	chuoQQ
酫	chuoQS
餟	chuoSQ
惙	chuoXQ
踔	chuoZ
趠	chuoZQ
踀	chuoZS
辵	chuoZT
逴	chuoZU
辶	chuoZV
础	chuPP
礎	chuPQ
欪	chuQQ
歜	chuQS
豖	chuQT
豠	chuQU
矗	chuS
岀	chuSQ
禇	chuSS
畜	chuT
埱	chuTQ
芻	chuUQ
菆	chuUS
蒢	chuUT
蒭	chuUU
藸	chuUV
储	chuV
儲	chuVQ
俶	chuVS
傗	chuVT
儊	chuVU
敊	chuWQ
珿	chuWS
璴	chuWT
怵	chuX
憷	chuXP
慉	chuXQ
諔	chuYQ
处	chuZ
躇	chuZC
蹰	chuZD
雏	chuZP
雛	chuZQ
貙	chuZS
趎	chuZT
躕	chuZU
赐	ciB
疵	ciBP
賜	ciBQ
皉	ciBS
蛓	ciCQ
螆	ciCS
蠀	ciCT
齹	ciCU
刺	ciD
刾	ciDQ
泚	ciEQ
濨	ciES
絘	ciFQ
縒	ciFS
差	ciG
庛	ciGQ
骴	ciGS
髊	ciGT
朿	ciIQ
柌	ciIS
栨	ciIT
糍	ciM
鹚	ciN
嬨	ciNQ
鴜	ciNS
鶿	ciNT
鷀	ciNU
呰	ciOQ
啙	ciOS
磁	ciP
礠	ciPQ
次	ciQ
祠	ciS
飺	ciSQ
餈	ciSS
垐	ciTQ
茨	ciU
茈	ciUP
茦	ciUQ
莿	ciUS
薋	ciUT
佌	ciVQ
佽	ciVS
偨	ciVT
瓷	ciW
玼	ciWQ
珁	ciWS
甆	ciWT
辞	ciX
慈	ciXP
辭	ciXQ
辝	ciXS
辤	ciXT
词	ciY
乲	ciYI
詞	ciYQ
鮆	ciYS
此	ciZ
雌	ciZP
趀	ciZQ
跐	ciZS
匆	congB
賨	congBQ
賩	congBS
従	congCQ
徔	congCS
徖	congCT
從	congCU
蟌	congCV
淙	congE
漎	congEQ
漗	congES
潀	congET
潈	congEU
潨	congEV
灇	congEW
聪	congF
聰	congFQ
繱	congFS
聡	congFT
聦	congFU
丛	congH
焧	congHQ
熜	congHS
爜	congHT
枞	congI
棇	congIQ
楤	congIS
樅	congIT
樬	congIU
樷	congIV
欉	congIW
錝	congJQ
鍯	congJS
鏓	congJT
鏦	congJU
篵	congKQ
骢	congM
瞛	congMQ
騘	congMS
驄	congMT
婃	congNQ
碂	congPQ
暰	congRQ
葱	congU
苁	congUP
蔥	congUQ
茐	congUS
蓯	congUT
藂	congUU
从	congV
囱	congW
璁	congWC
琮	congWP
囪	congWQ
瑽	congWS
忩	congXQ
怱	congXS
悤	congXT
悰	congXU
愡	congXV
慒	congXW
憁	congXX
叢	congYQ
誴	congYS
謥	congYT
孮	congZQ
凑	couB
辏	couC
輳	couCQ
湊	couEQ
楱	couI
腠	couL
傶	couVQ
攒	cuanA
撺	cuanAP
攅	cuanAQ
攛	cuanAS
攢	cuanAT
殩	cuanDQ
濽	cuanEQ
灒	cuanES
爨	cuanH
熶	cuanHQ
穳	cuanHS
櫕	cuanIQ
欑	cuanIS
镩	cuanJ
鋑	cuanJQ
鑹	cuanJS
篡	cuanK
簒	cuanKQ
汆	cuanR
巑	cuanSQ
菆	cuanUQ
窜	cuanX
竄	cuanXQ
窽	cuanXS
窾	cuanXT
蹿	cuanZ
躥	cuanZQ
瘄	cuBQ
瘯	cuBS
徂	cuC
殂	cuD
縬	cuFQ
摧	cuiA
瘁	cuiB
凗	cuiBQ
疩	cuiBS
皠	cuiBT
淬	cuiE
漼	cuiEQ
濢	cuiES
紣	cuiFQ
綷	cuiFS
縗	cuiFT
缞	cuiFU
焠	cuiHQ
熣	cuiHS
榱	cuiI
椊	cuiIQ
槯	cuiIS
鏙	cuiJQ
衰	cuiK
襊	cuiKQ
脆	cuiL
脃	cuiLQ
脺	cuiLS
膬	cuiLT
膵	cuiLU
臎	cuiLV
粹	cuiM
毳	cuiMP
粋	cuiMQ
啐	cuiO
啛	cuiOQ
磪	cuiPQ
橻	cuIQ
獕	cuiQQ
崔	cuiS
崒	cuiSQ
嵟	cuiSS
墔	cuiTQ
萃	cuiU
催	cuiV
伜	cuiVQ
倅	cuiVS
璀	cuiW
琗	cuiWQ
悴	cuiX
忰	cuiXQ
慛	cuiXS
竁	cuiXT
翠	cuiY
翆	cuiYQ
顇	cuiYS
趡	cuiZQ
觕	cuJQ
簇	cuK
脨	cuLQ
麁	cuLS
麄	cuLT
麆	cuLU
麤	cuLV
粗	cuM
鼀	cuMQ
拵	cunAQ
寸	cunC
刌	cunDQ
澊	cunEQ
邨	cunFQ
村	cunI
竴	cunLQ
膥	cunLS
籿	cunMQ
吋	cunOQ
皴	cunP
媨	cuNQ
墫	cunTQ
侟	cunVQ
忖	cunX
存	cunZ
踆	cunZQ
措	cuoA
搓	cuoAC
撮	cuoAD
挫	cuoAP
瘥	cuoB
痤	cuoBP
厝	cuoC
齹	cuoCQ
剉	cuoDQ
剒	cuoDS
縒	cuoFQ
酂	cuoFS
酇	cuoFT
庴	cuoGQ
虘	cuoHQ
错	cuoJ
锉	cuoJP
錯	cuoJQ
銼	cuoJS
鎈	cuoJT
鹾	cuoL
脞	cuoLP
鹺	cuoLQ
睉	cuoMQ
磋	cuoP
噈	cuOQ
醝	cuoQQ
矬	cuoS
嵯	cuoSP
嵳	cuoSQ
莝	cuoUQ
莡	cuoUS
蒫	cuoUT
蓌	cuoUU
蔖	cuoUV
瑳	cuoWQ
諎	cuoYQ
蹉	cuoZ
夎	cuoZQ
逪	cuoZS
遳	cuoZT
皻	cuPQ
醋	cuQ
酢	cuQC
猝	cuQP
卒	cuS
蔟	cuU
促	cuV
怚	cuXQ
憱	cuXS
誎	cuYQ
顣	cuYS
蹙	cuZ
蹴	cuZP
趗	cuZQ
趨	cuZS
踧	cuZT
踿	cuZU
蹵	cuZV
打	daA
搭	daAP
撘	daAQ
瘩	daB
匒	daBQ
蟽	daCQ
大	daD
耷	daDP
剳	daDQ
沓	daE
汏	daEQ
溚	daES
繨	daFQ
鞑	daG
靼	daGP
韃	daGQ
炟	daHQ
燵	daHS
贷	daiB
貣	daiBQ
貸	daiBS
待	daiC
蚮	daiCQ
蝳	daiCS
軑	daiCT
軚	daiCU
軩	daiCV
轪	daiCW
歹	daiD
殆	daiDP
歺	daiDQ
瀻	daiEQ
绐	daiF
紿	daiFQ
緿	daiFS
戴	daiG
廗	daiGQ
黛	daiH
黱	daiHQ
柋	daiIQ
带	daiJ
帶	daiJQ
帒	daiJS
帯	daiJT
釱	daiJU
袋	daiK
箉	daiKQ
簤	daiKS
襶	daiKT
隷	daiLQ
隸	daiLS
駘	daiMQ
鴏	daiNQ
呆	daiO
呔	daiOP
獃	daiQQ
曃	daiRQ
霴	daiRS
靆	daiRT
岱	daiS
埭	daiT
垈	daiTQ
代	daiV
傣	daiVP
侢	daiVQ
玳	daiW
瑇	daiWQ
怠	daiX
懛	daiXQ
甙	daiY
叇	daiYQ
詒	daiYS
逮	daiZ
迨	daiZP
艜	daiZQ
跢	daiZS
蹛	daiZT
鎉	daJQ
鎝	daJS
鐽	daJT
答	daK
笪	daKC
褡	daKP
笚	daKQ
龖	daLQ
龘	daLS
眔	daMQ
妲	daN
担	danA
掸	danAP
擔	danAQ
抌	danAS
撢	danAT
撣	danAU
单	danB
宕	danBC
赕	danBD
瘅	danBE
疸	danBP
癉	danBQ
癚	danBS
賧	danBT
贉	danBU
髧	danBV
蛋	danC
蜑	danCQ
殚	danD
刐	danDQ
殫	danDS
淡	danE
澹	danEP
沊	danEQ
泹	danES
耽	danF
聃	danFC
郸	danFP
匰	danFQ
紞	danFS
繵	danFT
耼	danFU
聸	danFV
鄲	danFW
弹	danG
挡	dangA
擋	dangAQ
攩	dangAS
蟷	dangCQ
党	dangE
氹	dangEQ
潒	dangES
澢	dangET
灙	dangEU
黨	dangHQ
档	dangI
檔	dangIQ
欓	dangIS
铛	dangJ
鐺	dangJQ
裆	dangK
筜	dangKQ
簜	dangKS
簹	dangKT
襠	dangKU
盪	dangMQ
瞊	dangMS
闣	dangMT
婸	dangNQ
噹	dangOQ
砀	dangP
碭	dangPQ
礑	dangPS
弾	danGQ
雼	dangRQ
彈	danGS
崵	dangSQ
嵣	dangSS
當	dangTQ
圵	dangTS
垱	dangTT
場	dangTU
壋	dangTV
荡	dangU
蕩	dangUQ
蘯	dangUS
偒	dangVQ
儅	dangVS
珰	dangWQ
璗	dangWS
璫	dangWT
瓽	dangWU
当	dangX
愓	dangXQ
谠	dangY
譡	dangYQ
讜	dangYS
艡	dangZQ
趤	dangZS
逿	dangZT
燀	danHQ
黕	danHS
黮	danHT
黵	danHU
柦	danIQ
帎	danJQ
觛	danJS
箪	danK
凼	danKP
簞	danKQ
衴	danKS
褝	danKT
襌	danKU
胆	danL
膽	danLQ
勯	danLS
腅	danLT
眈	danM
馾	danMQ
駳	danMS
妉	danNQ
媅	danNS
鴠	danNT
啖	danO
呾	danOQ
唌	danOS
啗	danOT
啿	danOU
單	danOV
嘾	danOW
噉	danOX
嚪	danOY
石	danP
丹	danPP
皽	danPQ
砃	danPS
氮	danQ
狚	danQQ
酖	danQS
醈	danQT
旦	danR
霮	danRQ
単	danSQ
禫	danSS
躭	danST
餤	danSU
饏	danSV
亶	danTQ
菪	danU
萏	danUP
蓞	danUQ
但	danV
儋	danVP
伔	danVQ
僤	danVS
玬	danWQ
瓭	danWS
甔	danWT
惮	danX
惔	danXQ
愖	danXS
憚	danXT
憺	danXU
窞	danXV
诞	danY
誕	danYQ
訑	danYS
頕	danYT
疍	danZQ
嗒	daO
捣	daoA
搗	daoAQ
捯	daoAS
擣	daoAT
导	daoC
導	daoCQ
螩	daoCS
到	daoD
刀	daoDP
刂	daoDQ
纛	daoF
絩	daoFQ
陦	daoFS
隝	daoFT
隯	daoFU
﨩	daoFV
稻	daoH
焘	daoHP
燾	daoHQ
稲	daoHS
朷	daoIQ
梼	daoIS
椡	daoIT
槝	daoIU
檤	daoIV
檮	daoIW
幬	daoJQ
釖	daoJS
箌	daoKQ
裯	daoKS
盗	daoM
盜	daoMQ
叨	daoO
嘄	daoOQ
噵	daoOS
哒	daOP
氘	daoQ
岛	daoS
祷	daoSP
島	daoSQ
禱	daoSS
嶋	daoST
嶌	daoSU
嶹	daoSV
禂	daoSW
軇	daoSX
噠	daOT
壔	daoTQ
呾	daOU
菿	daoUQ
倒	daoV
咑	daOW
瓙	daoWQ
悼	daoX
衜	daoXQ
衟	daoXS
翢	daoYQ
翿	daoYS
魛	daoYT
鱽	daoYU
道	daoZ
蹈	daoZP
舠	daoZQ
艔	daoZS
辺	daoZT
亣	daTQ
垯	daTS
墶	daTT
畗	daTU
畣	daTV
荅	daUQ
荙	daUS
薘	daUT
囗	daW
怛	daX
憚	daXQ
羍	daYQ
詚	daYS
达	daZ
達	daZQ
跶	daZS
躂	daZT
迏	daZU
迖	daZV
迚	daZW
逹	daZX
的	deB
德	deC
得	deCP
徳	deCQ
蚮	deCS
淂	deEQ
嘚	deiOQ
棏	deIQ
锝	deJ
鍀	deJQ
脦	deLQ
扥	denAQ
扽	denAS
登	dengB
豋	dengDQ
澂	dengEQ
瀓	dengES
邓	dengF
鄧	dengFQ
隥	dengFS
戥	dengG
灯	dengH
燈	dengHQ
櫈	dengIQ
凳	dengJ
镫	dengJP
覴	dengJQ
鐙	dengJS
等	dengK
簦	dengKP
竳	dengLQ
瞪	dengM
嬁	dengNQ
噔	dengO
磴	dengP
嶝	dengS
墱	dengTQ
僜	dengVQ
璒	dengWQ
憕	dengXQ
蹬	dengZ
艠	dengZQ
嘚	deOQ
旳	deRQ
地	deT
恴	deXQ
悳	deXS
惪	deXT
抵	diA
掂	dianA
攧	dianAQ
典	dianB
癜	dianBC
癫	dianBP
痁	dianBQ
痶	dianBS
瘨	dianBT
癲	dianBU
厧	dianCQ
蜔	dianCS
齻	dianCT
奠	dianD
丶	dianDP
奌	dianDQ
淀	dianE
滇	dianEP
澱	dianEQ
阽	dianF
店	dianG
点	dianH
點	dianHQ
扂	dianHS
椣	dianIQ
槇	dianIS
槙	dianIT
橂	dianIU
橝	dianIV
钿	dianJ
鈿	dianJQ
簟	dianK
驔	dianMQ
婝	dianNQ
婰	dianNS
嚸	dianOQ
殿	dianP
碘	dianPP
磹	dianPQ
靛	dianQ
猠	dianQQ
電	dianRQ
巅	dianS
巔	dianSQ
嵮	dianSS
巓	dianST
电	dianT
甸	dianTC
坫	dianTD
垫	dianTP
墊	dianTQ
壂	dianTS
蒧	dianUQ
蕇	dianUS
佃	dianV
佔	dianVQ
傎	dianVS
玷	dianW
敁	dianWQ
敟	dianWS
琔	dianWT
惦	dianX
窴	dianXQ
颠	dianY
顛	dianYQ
顚	dianYS
踮	dianZ
跕	dianZQ
蹎	dianZS
嗲	diaO
掉	diaoA
扚	diaoAQ
瘹	diaoBQ
虭	diaoCQ
蛁	diaoCS
刁	diaoD
凋	diaoDP
刟	diaoDQ
奝	diaoDS
汈	diaoEQ
絩	diaoFQ
弔	diaoGQ
弴	diaoGS
椆	diaoIQ
钓	diaoJ
铞	diaoJP
釣	diaoJQ
鈟	diaoJS
銚	diaoJT
銱	diaoJU
鋽	diaoJV
錭	diaoJW
鑃	diaoJX
簓	diaoKQ
竨	diaoLQ
盄	diaoMQ
瞗	diaoMS
鳥	diaoNQ
鳭	diaoNS
鵰	diaoNT
吊	diaoO
叼	diaoOP
碉	diaoP
屌	diaoPQ
雿	diaoRQ
彫	diaoSQ
鼦	diaoSS
蓧	diaoUQ
藋	diaoUS
伄	diaoVQ
琱	diaoWQ
窎	diaoXQ
窵	diaoXS
调	diaoY
鲷	diaoYP
訋	diaoYQ
誂	diaoYS
調	diaoYT
魡	diaoYU
鮉	diaoYV
鯛	diaoYW
雕	diaoZ
貂	diaoZP
扚	diAQ
拞	diAS
掋	diAT
揥	diAU
摕	diAV
的	diB
髢	diBQ
厎	diCQ
彽	diCS
蚳	diCT
蝃	diCU
蝭	diCV
螮	diCW
軧	diCX
奃	diDQ
滴	diE
揲	dieA
挕	dieAQ
镻	dieBQ
蝶	dieC
蜨	dieCQ
螲	dieCS
軼	dieCT
涤	diED
殜	dieDQ
泆	dieEQ
爹	dieF
絰	dieFQ
绖	dieFS
瓞	dieG
戜	dieGQ
鞢	dieGS
柣	dieIQ
楪	dieIS
槢	dieIT
幉	dieJQ
褋	dieKQ
褺	dieKS
耋	dieL
耊	dieLQ
胅	dieLS
氎	dieMQ
眣	dieMS
眰	dieMT
鴩	dieNQ
喋	dieO
咥	dieOQ
哋	dieOS
啑	dieOT
碟	dieP
牒	diePP
牃	diePQ
滌	diEQ
昳	dieRQ
曡	dieRS
浟	diES
峌	dieSQ
崼	dieSS
嵽	dieST
渧	diET
垤	dieTP
疊	dieTQ
堞	dieTR
畳	dieTS
疂	dieTT
疉	dieTU
苵	dieUQ
怢	dieXQ
恎	dieXS
惵	dieXT
叠	dieY
鲽	dieYC
谍	dieYP
諜	dieYQ
詄	dieYS
鰈	dieYT
跌	dieZ
迭	dieZP
臷	dieZQ
艓	dieZS
趃	dieZT
跕	dieZU
跮	dieZV
蹛	dieZW
缔	diF
邸	diFP
締	diFQ
聜	diFS
阺	diFT
隄	diFU
底	diG
骶	diGC
弟	diGP
弤	diGQ
靮	diGS
鞮	diGT
焍	diHQ
秪	diHS
棣	diI
柢	diIP
杕	diIQ
枑	diIS
枤	diIT
梊	diIU
梑	diIV
楴	diIW
樀	diIX
帝	diJ
觌	diJC
镝	diJP
覿	diJQ
觝	diJS
釱	diJT
鉪	diJU
鏑	diJV
第	diK
笛	diKP
篴	diKQ
袛	diKS
肑	diLQ
腣	diLS
睇	diM
眱	diMQ
糴	diMS
馰	diMT
娣	diN
掟	dingAQ
定	dingB
疔	dingBP
虰	dingCQ
鼎	dingD
鼑	dingDQ
濎	dingEQ
耵	dingF
聢	dingFQ
靪	dingGQ
丁	dingH
椗	dingIQ
钉	dingJ
锭	dingJP
釘	dingJQ
帄	dingJS
鋌	dingJT
錠	dingJU
鐤	dingJV
腚	dingL
盯	dingM
奵	dingNQ
叮	dingO
啶	dingOP
碇	dingP
矴	dingPQ
碠	dingPS
磸	dingPT
酊	dingQ
嵿	dingSQ
飣	dingSS
饤	dingST
町	dingT
甼	dingTQ
艼	dingUQ
萣	dingUS
薡	dingUT
仃	dingV
玎	dingW
忊	dingXQ
顶	dingY
订	dingYP
訂	dingYQ
頂	dingYS
顁	dingYT
嫡	diNP
媂	diNQ
牴	diNS
鸐	diNT
嘀	diO
呧	diOQ
哋	diOS
唙	diOT
啇	diOU
啲	diOV
嚁	diOW
砥	diP
氐	diPC
碲	diPP
碮	diPQ
磾	diPS
狄	diQ
豴	diQQ
籴	diR
旳	diRQ
祗	diS
岻	diSQ
嵽	diSS
嶳	diST
祶	diSU
禘	diSV
地	diT
坻	diTC
堤	diTP
坔	diTQ
坘	diTS
埅	diTT
埊	diTU
埞	diTV
墆	diTW
墑	diTX
墬	diTY
蒂	diU
颩	diuFQ
荻	diUH
丟	diuHQ
铥	diuJ
銩	diuJQ
丢	diuP
藡	diUQ
苐	diUS
苖	diUT
菂	diUU
菧	diUV
蓧	diUW
蔋	diUX
蔐	diUY
蔕	diUZ
低	diV
仾	diVQ
俤	diVS
偙	diVT
僀	diVU
敌	diW
敵	diWQ
玓	diWS
珶	diWT
甋	diWU
怟	diXQ
慸	diXS
谛	diY
诋	diYC
羝	diYD
翟	diYP
廸	diYQ
詆	diYS
諟	diYT
諦	diYU
頔	diYV
鯳	diYW
递	diZ
迪	diZP
遞	diZQ
疐	diZS
趆	diZT
踶	diZU
蹢	diZV
逓	diZW
遆	diZX
遰	diZY
挏	dongAQ
揰	dongAS
冻	dongB
凍	dongBQ
蝀	dongCQ
洞	dongE
涷	dongEQ
湩	dongES
絧	dongFQ
戙	dongGQ
鼕	dongGS
东	dongH
烔	dongHQ
燑	dongHS
栋	dongI
東	dongIQ
棟	dongIS
笗	dongKQ
箽	dongKS
动	dongL
胨	dongLC
胴	dongLP
動	dongLQ
勭	dongLS
腖	dongLT
駧	dongMQ
鸫	dongN
姛	dongNQ
娻	dongNS
嬞	dongNT
鶇	dongNU
鶫	dongNV
咚	dongO
硐	dongP
氡	dongQ
氭	dongQQ
狪	dongQS
昸	dongRQ
霘	dongRS
峒	dongS
岽	dongSP
崠	dongSQ
崬	dongSS
垌	dongT
埬	dongTQ
墥	dongTS
董	dongU
苳	dongUQ
菄	dongUS
蕫	dongUT
侗	dongV
倲	dongVQ
働	dongVS
懂	dongX
恫	dongXP
諌	dongYQ
鮗	dongYS
鯟	dongYT
冬	dongZ
迵	dongZQ
抖	douA
痘	douB
蚪	douC
斗	douD
豆	douDP
鬥	douDQ
剅	douDS
斣	douDT
鬦	douDU
鬪	douDV
鬬	douDW
鬭	douDX
兜	douE
兠	douEQ
浢	douES
瀆	douET
都	douF
陡	douFP
郖	douFQ
阧	douFS
枓	douIQ
梪	douIS
橷	douIT
钭	douJ
鈄	douJQ
鋀	douJS
篼	douK
脰	douLQ
毭	douMQ
瞗	douMS
閗	douMT
闘	douMU
吋	douOQ
吺	douOS
唗	douOT
唞	douOU
狵	douQQ
酘	douQS
餖	douSQ
饾	douSS
蔸	douU
荳	douUQ
乧	douVQ
侸	douVS
窦	douX
竇	douXQ
讀	douYQ
逗	douZ
剬	duanDQ
耑	duanEQ
缎	duanF
緞	duanFQ
煅	duanH
椴	duanI
断	duanJ
锻	duanJP
斷	duanJQ
鍛	duanJS
鍴	duanJT
簖	duanK
籪	duanKQ
褍	duanKS
端	duanL
腶	duanLQ
媏	duanNQ
段	duanP
毈	duanPQ
碫	duanPS
短	duanS
塅	duanTQ
葮	duanUQ
偳	duanVQ
瑖	duanWQ
躖	duanZQ
赌	duB
賭	duBQ
凟	duBS
贕	duBT
蠹	duC
螙	duCQ
蠧	duCS
剢	duDQ
殬	duDS
殰	duDT
渡	duE
渎	duEP
瀆	duEQ
涜	duES
都	duF
匵	duFQ
度	duG
髑	duGP
豄	duGQ
靯	duGS
韇	duGT
黩	duH
秺	duHQ
黷	duHS
杜	duI
兑	duiB
痽	duiBQ
对	duiC
對	duiCQ
対	duiCS
轛	duiCT
兊	duiEQ
兌	duiES
濧	duiET
濻	duiEU
瀢	duiEV
瀩	duiEW
队	duiF
綐	duiFQ
陮	duiFS
隊	duiFT
杸	duiIQ
镦	duiJ
錞	duiJQ
鐓	duiJS
鐜	duiJT
鴭	duiNQ
啍	duiOQ
椟	duIP
磓	duiPQ
碓	duiPR
櫝	duIQ
祋	duiSQ
堆	duiT
垖	duiTQ
塠	duiTS
薱	duiUQ
敦	duiW
敓	duiWQ
敚	duiWS
怼	duiX
憝	duiXP
憞	duiXQ
懟	duiXS
譈	duiYQ
譵	duiYS
頧	duiYT
镀	duJ
鍍	duJQ
覩	duJS
錖	duJT
鑟	duJU
笃	duK
篤	duKQ
裻	duKS
肚	duL
毒	duM
睹	duMC
督	duMP
闍	duMQ
阇	duMS
騳	duMT
妒	duN
撉	dunAQ
撴	dunAS
犊	duNC
蜳	dunCQ
沌	dunE
潡	dunEQ
庉	dunGQ
炖	dunH
燉	dunHQ
楯	dunIQ
橔	dunIS
钝	dunJ
鈍	dunJQ
鐓	dunJS
盾	dunM
盹	dunMP
驐	dunMQ
犜	dunNQ
吨	dunO
噸	dunOQ
礅	dunP
砘	dunPP
碷	dunPQ
妬	duNQ
獤	dunQQ
姤	duNS
壿	dunSQ
墩	dunT
坉	dunTQ
墪	dunTS
墫	dunTT
犢	duNU
嬻	duNV
伅	dunVQ
敦	dunW
囤	dunWP
忳	dunXQ
惇	dunXS
憞	dunXT
顿	dunY
頓	dunYQ
蹲	dunZ
趸	dunZC
遁	dunZP
踲	dunZQ
蹾	dunZS
躉	dunZT
逇	dunZU
遯	dunZV
嘟	duO
掇	duoA
挅	duoAQ
挆	duoAS
凙	duoBQ
痥	duoBS
鬌	duoBT
夺	duoD
剁	duoDP
奪	duoDQ
刴	duoDS
剟	duoDT
剫	duoDU
奲	duoDV
沲	duoE
沰	duoEQ
澤	duoES
缍	duoF
綞	duoFQ
陊	duoFS
陏	duoFT
隓	duoFU
度	duoG
朵	duoI
朶	duoIQ
杕	duoIS
杝	duoIT
枤	duoIU
柂	duoIV
柮	duoIW
桗	duoIX
椯	duoIY
铎	duoJ
鈬	duoJQ
鐸	duoJS
裰	duoK
袳	duoKQ
毲	duoMQ
馱	duoMS
駄	duoMT
媠	duoNQ
鵽	duoNS
哆	duoO
哚	duoOC
咄	duoOP
喥	duoOQ
嚉	duoOS
嚲	duoOT
硾	duoPQ
叾	duOQ
躲	duoS
崜	duoSQ
躱	duoSS
軃	duoST
飿	duoSU
饳	duoSV
堕	duoT
垛	duoTP
亸	duoTQ
垜	duoTS
埵	duoTT
墮	duoTU
墯	duoTV
畓	duoTW
仛	duoVQ
敓	duoWQ
敚	duoWS
敠	duoWT
敪	duoWU
多	duoX
惰	duoXP
夛	duoXQ
憜	duoXS
尮	duoYQ
踱	duoZ
跺	duoZC
舵	duoZP
趓	duoZQ
跢	duoZS
跥	duoZT
﨣	duoZU
牍	duP
牘	duPQ
皾	duPS
独	duQ
獨	duQQ
醏	duQS
晵	duRQ
暏	duRS
厾	duSQ
堵	duT
芏	duU
荰	duUQ
斁	duWQ
琽	duWS
瓄	duWT
韣	duWU
韥	duWV
读	duY
讀	duYQ
頓	duYS
読	duYT
讟	duYU
扼	eA
搕	eAQ
搤	eAS
搹	eAT
擜	eAU
匎	eBQ
痷	eBS
痾	eBT
皒	eBU
齃	eBV
蛾	eC
轭	eCC
厄	eCP
蚅	eCQ
蝁	eCS
軛	eCT
軶	eCU
齶	eCV
湂	eEK
洝	eEQR
涐	eESR
阿	eF
鄂	eFP
阨	eFQ
阸	eFS
廅	eGQ
戹	eHQ
枙	eIQ
欸	eiQQ
櫮	eIS
诶	eiY
誒	eiYQ
锷	eJ
锇	eJP
卾	eJQ
覨	eJS
鈋	eJT
鈪	eJU
鋨	eJV
鍔	eJW
鑩	eJX
腭	eL
睋	eMQ
閼	eMS
騀	eMT
鹅	eN
摁	enA
婀	eNC
鹗	eND
奀	enDQ
鞥	engGQ
煾	enHQ
嗯	enO
娥	eNP
鵝	eNQ
鶚	eNS
峎	enSQ
妸	eNT
妿	eNU
蒽	enUR
姶	eNV
娾	eNW
恩	enX
娿	eNXR
鵈	eNY
鵞	eNZ
哦	eO
噩	eOC
呃	eOP
吪	eOQ
呝	eOS
咢	eOT
咹	eOU
噁	eOV
屙	eP
砈	ePQ
砐	ePS
砨	ePT
硆	ePU
磀	ePV
礘	ePW
歞	eQQ
豟	eQS
贰	erB
貳	erBQ
貮	erBS
髵	erBT
髶	erBU
輀	erCQ
轜	erCS
刵	erDQ
而	erE
儿	erEC
洱	erED
二	erEP
児	erEQ
兒	erES
洏	erET
耏	erEU
耳	erF
聏	erFQ
陑	erFS
隭	erFT
杒	erIQ
栭	erIS
栮	erIT
梕	erIU
樲	erIV
铒	erJ
鉺	erJQ
袻	erKQ
胹	erLQ
臑	erLS
毦	erMQ
粫	erMS
駬	erMT
鸸	erN
鴯	erNQ
咡	erOQ
唲	erOS
饵	erS
餌	erSQ
峏	erSS
荋	erUQ
薾	erUS
乻	erVQ
侕	erVS
珥	erW
尔	erX
爾	erXQ
尒	erXS
尓	erXT
衈	erXU
鲕	erY
弍	erYQ
弐	erYS
誀	erYT
鮞	erYU
迩	erZ
趰	erZQ
邇	erZS
饿	eS
峨	eSP
餓	eSQ
岋	eSS
峉	eST
峩	eSU
崿	eSV
餩	eSW
垩	eT
堊	eTQ
堨	eTS
堮	eTT
萼	eU
苊	eUC
莪	eUP
蕚	eUQ
俄	eV
偔	eVQ
僫	eVS
囮	eWQ
敋	eWS
珴	eWT
琧	eWU
恶	eX
愕	eXP
悪	eXQ
惡	eXS
额	eY
颚	eYC
讹	eYD
谔	eYE
頟	eYK
頞	eYL
頋	eYM
讍	eYN
譌	eYO
鳄	eYP
鱷	eYQ
額	eYS
訛	eYT
鰪	eYU
鰐	eYV
魤	eYW
顎	eYX
誐	eYY
諤	eYZ
遏	eZ
迗	eZQ
遌	eZS
遻	eZT
發	faBQ
疺	faBS
発	faBT
冹	faBU
髪	faBV
髮	faBW
法	faE
沷	faEQ
灋	faES
浌	faET
彂	faGQ
栰	faIQ
橃	faIS
鍅	faJQ
筏	faK
笩	faKQ
阀	faM
閥	faMQ
瞂	faMS
払	fanAQ
贩	fanB
販	fanBQ
蠜	fanCQ
軓	fanCS
軬	fanCT
輽	fanCU
轓	fanCV
樊	fanD
泛	fanE
氾	fanEQ
汎	fanES
滼	fanET
瀪	fanEU
瀿	fanEV
繁	fanF
匥	fanFQ
旙	fanFS
旛	fanFT
緐	fanFU
繙	fanFV
颿	fanFW
飜	fanFX
髣	fangBQ
蚄	fangCQ
汸	fangEQ
淓	fangES
方	fangF
纺	fangFC
邡	fangFD
防	fangFP
紡	fangFQ
旊	fangFS
匚	fangFT
房	fangH
枋	fangI
钫	fangJ
鈁	fangJQ
錺	fangJS
肪	fangL
眆	fangMQ
眪	fangMS
妨	fangN
牥	fangNQ
鴋	fangNS
鶭	fangNT
昉	fangRQ
昘	fangRS
祊	fangSQ
坊	fangT
埅	fangTQ
堏	fangTS
芳	fangU
仿	fangV
倣	fangVQ
放	fangW
瓬	fangWQ
访	fangY
鲂	fangYP
訪	fangYQ
魴	fangYS
舫	fangZ
趽	fangZQ
烦	fanH
燔	fanHP
煩	fanHQ
梵	fanI
杋	fanIQ
柉	fanIS
桳	fanIT
棥	fanIU
橎	fanIV
凡	fanJ
幡	fanJC
钒	fanJD
帆	fanJP
凢	fanJQ
凣	fanJS
釩	fanJT
鐇	fanJU
範	fanKQ
笲	fanKS
笵	fanKT
籓	fanKU
襎	fanKV
勫	fanLQ
膰	fanLS
盕	fanMQ
籵	fanMS
奿	fanNQ
婏	fanNS
嬎	fanNT
嬏	fanNU
鷭	fanNV
噃	fanOQ
矾	fanP
礬	fanPQ
犯	fanQ
犿	fanQQ
饭	fanS
飯	fanSQ
飰	fanSS
番	fanT
畈	fanTP
墦	fanTQ
畨	fanTS
范	fanU
蕃	fanUC
蘩	fanUD
藩	fanUP
薠	fanUQ
姂	faNV
仮	fanVQ
攵	fanW
璠	fanWQ
忛	fanXQ
憣	fanXS
反	fanY
翻	fanYP
羳	fanYQ
訉	fanYS
鱕	fanYT
返	fanZ
夂	fanZC
蹯	fanZP
舤	fanZQ
舧	fanZS
乏	faP
砝	faPP
酦	faQQ
醗	faQS
醱	faQT
罚	faS
罰	faSQ
峜	faSS
罸	faST
垡	faT
坺	faTQ
墢	faTS
茷	faUQ
蕟	faUS
藅	faUT
伐	faV
佱	faVQ
傠	faVS
珐	faW
琺	faWQ
发	faY
费	feiB
痱	feiBP
發	feiBQ
費	feiBS
疿	feiBT
癈	feiBU
蜚	feiC
厞	feiCQ
蜰	feiCS
蟦	feiCT
剕	feiDQ
奜	feiDS
沸	feiE
淝	feiEP
渄	feiEQ
濷	feiES
非	feiF
匪	feiFC
绯	feiFD
飞	feiFP
飛	feiFQ
緋	feiFS
陫	feiFT
靟	feiFU
飝	feiFV
废	feiG
廢	feiGQ
廃	feiGS
扉	feiH
榧	feiI
杮	feiIQ
柹	feiIS
棐	feiIT
橃	feiIU
橨	feiIV
櫠	feiIW
镄	feiJ
鐨	feiJQ
篚	feiK
笰	feiKQ
裶	feiKS
肥	feiL
腓	feiLC
肺	feiLP
朏	feiLQ
胇	feiLS
胏	feiLT
胐	feiLU
騑	feiMQ
騛	feiMS
妃	feiN
婓	feiNQ
婔	feiNS
啡	feiO
吠	feiOP
砩	feiP
屝	feiPQ
狒	feiQ
犻	feiQQ
猆	feiQS
霏	feiR
昲	feiRQ
暃	feiRS
曊	feiRT
靅	feiRU
餥	feiSQ
鼣	feiSS
菲	feiU
芾	feiUP
萉	feiUQ
蕜	feiUS
俷	feiVQ
斐	feiW
悱	feiX
馡	feiXQ
翡	feiY
鲱	feiYC
诽	feiYP
誹	feiYQ
鯡	feiYS
黺	fenBQ
蚠	fenCQ
蚡	fenCS
轒	fenCT
分	fenD
奋	fenDP
奮	fenDQ
哛	fenDS
汾	fenE
瀵	fenEP
濆	fenEQ
纷	fenF
紛	fenFQ
隫	fenFS
摓	fengAQ
冯	fengB
疯	fengBP
瘋	fengBQ
寷	fengBS
賵	fengBT
赗	fengBU
封	fengC
蜂	fengCP
蠭	fengCQ
奉	fengD
豐	fengDQ
沣	fengE
沨	fengEQ
浲	fengES
渢	fengET
湗	fengEU
溄	fengEV
漨	fengEW
灃	fengEX
风	fengF
酆	fengFC
缝	fengFP
縫	fengFQ
風	fengFS
綘	fengFT
鄷	fengFU
飌	fengFV
烽	fengH
炐	fengHQ
焨	fengHS
煈	fengHT
熢	fengHU
枫	fengI
楓	fengIQ
桻	fengIS
檒	fengIT
锋	fengJ
凤	fengJP
鋒	fengJQ
凨	fengJS
凬	fengJT
凮	fengJU
鎽	fengJV
鏠	fengJW
篈	fengKQ
丰	fengL
盽	fengMQ
馮	fengMS
麷	fengMT
鳳	fengNQ
妦	fengNS
犎	fengNT
鳯	fengNU
鴌	fengNV
唪	fengO
砜	fengP
碸	fengPQ
弅	fenGQ
猦	fengQQ
靊	fengRQ
峰	fengS
峯	fengSQ
鼖	fenGSR
崶	fengSS
埄	fengTQ
堸	fengTS
堼	fengTT
葑	fengU
莑	fengUQ
蘴	fengUS
俸	fengV
仹	fengVQ
偑	fengVS
僼	fengVT
琒	fengWQ
覂	fengXQ
讽	fengY
諷	fengYQ
逢	fengZ
夆	fengZQ
艂	fengZS
焚	fenH
炃	fenHQ
燌	fenHS
燓	fenHT
秎	fenHU
棼	fenI
枌	fenIQ
梤	fenIS
棻	fenIT
橨	fenIU
帉	fenJQ
幩	fenJS
鈖	fenJT
鐼	fenJU
衯	fenKQ
朌	fenLQ
竕	fenLS
膹	fenLT
黂	fenLU
粉	fenM
粪	fenMP
糞	fenMQ
瞓	fenMS
妢	fenNQ
鳻	fenNS
吩	fenO
砏	fenPQ
氛	fenQ
酚	fenQP
獖	fenQQ
豮	fenQS
豶	fenQT
昐	fenRQ
朆	fenRS
雰	fenRT
鼢	fenS
岎	fenSQ
餴	fenSS
饙	fenST
躮	fenSU
坟	fenT
墳	fenTQ
坆	fenTS
坋	fenTT
芬	fenU
蒶	fenUQ
蕡	fenUS
份	fenV
偾	fenVP
僨	fenVQ
瓰	fenWQ
愤	fenX
忿	fenXP
憤	fenXQ
馚	fenXS
馩	fenXT
鲼	fenY
羒	fenYQ
羵	fenYS
翂	fenYT
訜	fenYU
魵	fenYV
鱝	fenYW
覅	fiaoXQ
梻	foIQ
坲	foTQ
殕	fouDQ
缶	fouF
紑	fouFQ
缹	fouFS
缻	fouFT
炰	fouHQ
妚	fouNQ
鴀	fouNS
否	fouO
雬	fouRQ
佛	foV
仏	foVQ
仸	foVS
扶	fuA
拂	fuAC
拊	fuAD
抚	fuAP
撫	fuAQ
払	fuAS
抙	fuAT
捊	fuAU
捬	fuAV
负	fuB
赋	fuBC
匐	fuBD
赙	fuBE
富	fuBP
負	fuBQ
賦	fuBS
癁	fuBT
賻	fuBU
髴	fuBV
辐	fuC
蝠	fuCC
蝮	fuCD
蚨	fuCE
蜉	fuCF
蝜	fuCN
蜅	fuCO
辅	fuCP
輻	fuCQ
輔	fuCS
復	fuCT
輹	fuCU
尃	fuCV
彿	fuCW
蚥	fuCX
蚹	fuCY
蛗	fuCZ
夫	fuD
跗	fuDE
副	fuDP
刜	fuDQ
浮	fuE
滏	fuEC
涪	fuEP
泭	fuEQ
洑	fuES
澓	fuET
父	fuF
缚	fuFC
阜	fuFD
釜	fuFE
绋	fuFF
绂	fuFG
郛	fuFH
喸	fuFO
附	fuFP
縛	fuFQ
紨	fuFS
紱	fuFT
紼	fuFU
絥	fuFV
綍	fuFW
綒	fuFX
緮	fuFY
乶	fuFZ
府	fuG
艴	fuGC
弗	fuGP
弣	fuGQ
鬴	fuGS
馥	fuH
稃	fuHP
炥	fuHQ
烰	fuHS
焤	fuHT
秿	fuHU
稪	fuHV
虙	fuHW
桴	fuI
﨓	fuIN
椨	fuIO
榑	fuIQ
椱	fuIS
枎	fuIT
枹	fuIU
柎	fuIV
柫	fuIW
柭	fuIX
栿	fuIY
棴	fuIZ
幅	fuJ
凫	fuJC
幞	fuJD
斧	fuJP
巿	fuJQ
帗	fuJS
鈇	fuJT
鉘	fuJU
鉜	fuJV
鍑	fuJW
鍢	fuJX
符	fuK
袝	fuKM
袚	fuKN
衭	fuKO
袱	fuKP
襥	fuKQ
襆	fuKS
褔	fuKT
複	fuKU
笰	fuKV
筟	fuKW
箁	fuKX
箙	fuKY
簠	fuKZ
服	fuL
肤	fuLC
脯	fuLD
腑	fuLE
腹	fuLP
膚	fuLQ
竎	fuLS
胕	fuLT
麸	fuM
驸	fuMP
冨	fuMQ
盙	fuMS
粰	fuMT
糐	fuMU
駙	fuMV
麩	fuMW
麬	fuMX
麱	fuMY
妇	fuN
嬔	fuNK
媍	fuNL
婏	fuNM
娐	fuNN
姇	fuNO
婦	fuNQ
鶝	fuNS
鵩	fuNT
鴔	fuNU
鳺	fuNV
鳬	fuNW
鳧	fuNX
乀	fuNY
妋	fuNZ
咐	fuO
呒	fuOC
呋	fuOP
咈	fuOQ
哹	fuOS
嘸	fuOT
砆	fuPQ
氟	fuQ
豧	fuQQ
酜	fuQS
腐	fuR
福	fuS
祓	fuSC
罘	fuSP
岪	fuSQ
峊	fuSS
祔	fuST
禣	fuSU
罦	fuSV
坿	fuTQ
垘	fuTS
垺	fuTT
甶	fuTU
畉	fuTV
畐	fuTW
畗	fuTX
芙	fuU
苻	fuUC
莆	fuUD
芾	fuUE
莩	fuUF
菔	fuUG
茯	fuUP
芣	fuUQ
茀	fuUS
荂	fuUT
荴	fuUU
萯	fuUV
葍	fuUW
蓲	fuUX
蕧	fuUY
付	fuV
傅	fuVC
俯	fuVD
俘	fuVE
伏	fuVP
伕	fuVQ
俌	fuVS
俛	fuVT
偩	fuVU
敷	fuW
玞	fuWQ
玸	fuWS
琈	fuWT
璷	fuWU
韍	fuWV
韨	fuWW
覆	fuX
怫	fuXP
怤	fuXQ
懯	fuXS
覄	fuXT
甫	fuY
黻	fuYC
鲋	fuYD
鳆	fuYE
黼	fuYF
乥	fuYI
讣	fuYP
翇	fuYQ
訃	fuYS
詂	fuYT
諨	fuYU
頫	fuYV
鮄	fuYW
鮒	fuYX
鰒	fuYY
鮲	fuYZ
复	fuZ
孵	fuZC
孚	fuZD
趺	fuZF
赴	fuZP
艀	fuZQ
踾	fuZS
纀	fwFQ
旉	fwFS
阝	fwFT
邞	fwFU
郙	fwFV
鄜	fwFW
釡	fwFX
颫	fwFY
颰	fwFZ
轧	gaC
軋	gaCQ
夹	gaD
夾	gaDQ
魀	gaGQ
摡	gaiAQ
赅	gaiB
匃	gaiBQ
匄	gaiBS
賅	gaiBT
賌	gaiBU
溉	gaiE
漑	gaiEQ
陔	gaiF
絠	gaiFQ
絯	gaiFS
郂	gaiFT
隑	gaiFU
戤	gaiG
丐	gaiH
概	gaiI
杚	gaiIQ
槩	gaiIS
槪	gaiIT
钙	gaiJ
鈣	gaiJQ
盖	gaiM
姟	gaiNQ
硙	gaiPQ
磑	gaiPS
豥	gaiQQ
晐	gaiRQ
峐	gaiSQ
祴	gaiSS
畡	gaiTQ
芥	gaiU
荄	gaiUQ
葢	gaiUS
蓋	gaiUT
乢	gaiVQ
侅	gaiVS
改	gaiW
瓂	gaiWQ
忋	gaiXQ
该	gaiY
該	gaiYQ
钆	gaJ
釓	gaJQ
錷	gaJS
朒	gaLQ
擀	ganA
赣	ganB
疳	ganBP
凎	ganBQ
贑	ganBS
贛	ganBT
泔	ganE
澉	ganEC
淦	ganEP
汵	ganEQ
漧	ganES
澸	ganET
灨	ganEU
绀	ganF
紺	ganFQ
干	ganG
掆	gangAQ
摃	gangAS
冮	gangBQ
疘	gangBS
刚	gangD
剛	gangDQ
港	gangE
纲	gangF
缸	gangFP
綱	gangFQ
罁	gangFS
焵	gangHQ
焹	gangHS
杠	gangI
棡	gangIQ
槓	gangIS
钢	gangJ
鋼	gangJQ
釭	gangJS
鎠	gangJT
筻	gangK
肛	gangL
牨	gangNQ
犅	gangNS
甘	ganGP
矼	gangPQ
碙	gangPS
幹	ganGQ
犺	gangQQ
岗	gangS
罡	gangSP
岡	gangSQ
骭	ganGSR
崗	gangSS
冈	gangT
堈	gangTQ
魐	ganGTR
堽	gangTS
戆	gangX
戅	gangXQ
戇	gangXS
秆	ganH
稈	ganHQ
杆	ganI
橄	ganIC
柑	ganIP
桿	ganIQ
榦	ganIS
檊	ganIT
凲	ganJQ
竿	ganK
笴	ganKQ
筸	ganKS
篢	ganKT
簳	ganKU
衦	ganKV
肝	ganL
盰	ganMQ
粓	ganMS
姏	ganNQ
鳱	ganNS
咁	ganOQ
矸	ganP
皯	ganPQ
酐	ganQ
旰	ganR
坩	ganT
苷	ganU
芉	ganUQ
乹	ganVQ
亁	ganVS
仠	ganVT
佄	ganVU
倝	ganVV
敢	ganW
攼	ganWQ
玕	ganWS
玵	ganWT
感	ganX
忓	ganXQ
尴	ganY
尷	ganYQ
尲	ganYS
尶	ganYT
詌	ganYU
鱤	ganYV
鳡	ganYW
赶	ganZ
趕	ganZQ
迀	ganZS
嘎	gaO
搞	gaoA
皋	gaoB
皐	gaoBQ
夰	gaoDQ
缟	gaoF
郜	gaoFP
縞	gaoFQ
高	gaoG
髙	gaoGQ
鼛	gaoGS
稿	gaoH
羔	gaoHP
稁	gaoHQ
稾	gaoHS
槁	gaoI
槔	gaoIP
槀	gaoIQ
槹	gaoIS
橰	gaoIT
檺	gaoIU
櫜	gaoIV
镐	gaoJ
锆	gaoJP
鋯	gaoJQ
鎬	gaoJS
篙	gaoK
筶	gaoKQ
膏	gaoL
勂	gaoLQ
糕	gaoM
睪	gaoMQ
鷎	gaoNQ
鷱	gaoNS
告	gaoO
吿	gaoOQ
噶	gaOP
嘠	gaOQ
獋	gaoQQ
杲	gaoR
暠	gaoRQ
峼	gaoSQ
祮	gaoSS
祰	gaoST
禞	gaoSU
餻	gaoSV
藁	gaoU
菒	gaoUQ
藳	gaoUS
韟	gaoWQ
睾	gaoX
诰	gaoY
羙	gaoYQ
誥	gaoYS
臯	gaoZQ
旮	gaR
垓	gaT
玍	gaWQ
尕	gaX
尜	gaXP
尬	gaY
搁	geA
搿	geAP
擱	geAQ
扢	geAS
挌	geAT
疙	geB
匌	geBQ
蛤	geC
虼	geCP
蛒	geCQ
輵	geCS
轕	geCT
割	geD
滆	geEQ
滒	geES
隔	geF
纥	geFP
紇	geFQ
革	geG
骼	geGC
戈	geGP
彁	geGQ
戓	geGS
戨	geGT
鞈	geGU
鞷	geGV
鬲	geH
格	geI
给	geiF
給	geiFQ
槅	geIQ
櫊	geIS
镉	geJC
铬	geJP
觡	geJQ
鉻	geJS
鎑	geJT
鎘	geJU
鎶	geJV
袼	geK
笴	geKQ
箇	geKS
裓	geKT
胳	geL
哿	geLC
膈	geLP
肐	geLQ
臈	geLS
阁	geM
閣	geMQ
閤	geMS
騔	geMT
鸽	geN
揯	genAQ
搄	genAS
亙	genEQ
艮	genG
挭	gengAQ
賡	gengBQ
刯	gengDQ
浭	gengEQ
耿	gengF
绠	gengFP
絙	gengFQ
絚	gengFS
綆	gengFT
緪	gengFU
縆	gengFV
郠	gengFW
庚	gengG
赓	gengGP
骾	gengGQ
更	gengH
焿	gengHQ
梗	gengI
椩	gengIQ
耕	gengL
鶊	gengNQ
鹒	gengNS
哽	gengO
暅	gengRQ
峺	gengSQ
埂	gengT
堩	gengTQ
畊	gengTS
莄	gengUQ
菮	gengUS
羹	gengY
鲠	gengYP
羮	gengYQ
頸	gengYS
鯁	gengYT
亘	genH
根	genI
哏	genO
鴿	geNQ
牫	geNS
鴚	geNT
茛	genU
跟	genZ
各	geO
咯	geOC
嗝	geOD
合	geOE
哥	geOP
吤	geOQ
呄	geOS
嗰	geOT
嘅	geOU
硌	geP
歌	geQ
犵	geQQ
猲	geQS
獦	geQT
餎	geSQ
饹	geSS
圪	geT
塥	geTP
葛	geU
茖	geUQ
蓋	geUS
虄	geUT
个	geV
仡	geVP
個	geVQ
佫	geVS
佮	geVT
敋	geWQ
韐	geWS
韚	geWT
愅	geXQ
颌	geY
諽	geYQ
謌	geYS
頜	geYT
魺	geYU
鮥	geYV
鮯	geYW
鲄	geYX
舸	geZ
臵	geZQ
怾	giXQ
拱	gongA
拲	gongAQ
公	gongB
宫	gongBC
贡	gongBD
共	gongBP
宮	gongBQ
貢	gongBS
贛	gongBT
匑	gongBU
匔	gongBV
髸	gongBW
蚣	gongC
輁	gongCQ
汞	gongE
澒	gongEQ
兝	gongFQ
糼	gongFS
糿	gongFT
紅	gongFU
工	gongG
弓	gongGC
巩	gongGP
鞏	gongGQ
廾	gongGS
熕	gongHQ
杛	gongIQ
栱	gongIS
觥	gongJ
幊	gongJQ
觵	gongJS
銾	gongJT
篢	gongKQ
功	gongL
肱	gongLC
龚	gongLP
兣	gongLQ
龏	gongLS
龔	gongLT
唝	gongOQ
嗊	gongOS
碽	gongPQ
躬	gongS
厷	gongSQ
躳	gongSS
塨	gongTQ
供	gongV
侊	gongVQ
攻	gongW
珙	gongWP
恭	gongX
愩	gongXQ
慐	gongXS
羾	gongYQ
搆	gouAQ
撀	gouAS
购	gouB
勾	gouBP
購	gouBQ
痀	gouBS
蚼	gouCQ
沟	gouE
溝	gouEQ
缑	gouF
緱	gouFQ
鞲	gouG
煹	gouHQ
构	gouI
枸	gouIP
構	gouIQ
钩	gouJ
觏	gouJP
鉤	gouJQ
覯	gouJS
鈎	gouJT
篝	gouK
笱	gouKP
簼	gouKQ
袧	gouKS
褠	gouKT
耇	gouLQ
耈	gouLS
耉	gouLT
糓	gouMQ
媾	gouN
姤	gouNQ
呴	gouOQ
啂	gouOS
彀	gouP
狗	gouQ
岣	gouSQ
垢	gouT
冓	gouTQ
坸	gouTS
苟	gouU
芶	gouUQ
佝	gouV
傋	gouVQ
玽	gouWQ
韝	gouWS
够	gouX
夠	gouXQ
诟	gouY
訽	gouYQ
詬	gouYS
遘	gouZ
豿	gouZQ
雊	gouZS
挂	guaA
掛	guaAQ
寡	guaB
卦	guaBP
刮	guaD
剐	guaDP
剮	guaDQ
劀	guaDS
絓	guaFQ
緺	guaFS
颪	guaFT
颳	guaFU
瓜	guaG
煱	guaHQ
栝	guaI
拐	guaiA
掴	guaiAP
摑	guaiAQ
夬	guaiDQ
枴	guaiIQ
柺	guaiIS
箉	guaiKQ
乖	guaiP
桰	guaIQ
罫	guaiSQ
怪	guaiX
恠	guaiXQ
叏	guaiYQ
銛	guaJQ
銽	guaJS
铦	guaJT
褂	guaK
袿	guaKQ
胍	guaL
騧	guaMQ
鸹	guaN
掼	guanA
摜	guanAQ
关	guanB
贯	guanBC
官	guanBP
貫	guanBQ
卝	guanBS
痯	guanBT
瘝	guanBU
癏	guanBV
輨	guanCQ
灌	guanE
涫	guanEP
泴	guanEQ
淉	guanES
潅	guanET
罐	guanF
纶	guanFP
綸	guanFQ
罆	guanFS
挄	guangAQ
撗	guangAS
臦	guangCQ
臩	guangCS
輄	guangCT
光	guangE
洸	guangEQ
广	guangG
廣	guangGQ
広	guangGS
灮	guangHQ
炗	guangHS
炚	guangHT
炛	guangHU
烡	guangHV
黆	guangHW
桄	guangI
銧	guangJQ
胱	guangL
姯	guangNQ
咣	guangO
硄	guangPQ
犷	guangQ
獷	guangQQ
垙	guangTQ
茪	guangUQ
俇	guangVQ
僙	guangVS
珖	guangWQ
逛	guangZ
爟	guanHQ
棺	guanI
樌	guanIQ
欟	guanIS
观	guanJ
矜	guanJP
觀	guanJQ
覌	guanJS
観	guanJT
錧	guanJU
鏆	guanJV
鑵	guanJW
管	guanK
筦	guanKQ
丱	guanLQ
冠	guanM
盥	guanMP
關	guanMQ
毌	guanMS
矔	guanMT
矝	guanMU
閞	guanMV
関	guanMW
闗	guanMX
鹳	guanN
鸛	guanNQ
礶	guanPQ
鴰	guaNQ
豘	guanQQ
馆	guanS
館	guanSQ
祼	guanSS
舘	guanST
莞	guanU
蒄	guanUQ
倌	guanV
琯	guanWQ
璭	guanWS
瓘	guanWT
惯	guanX
慣	guanXQ
悹	guanXS
悺	guanXT
窤	guanXU
鳏	guanY
鰥	guanYQ
鱞	guanYS
鱹	guanYT
鳤	guanYU
躀	guanZQ
遦	guanZS
雚	guanZT
呱	guaO
叧	guaOQ
咼	guaOS
啩	guaOT
扢	guAQ
歄	guaQQ
抇	guAS
罣	guaSQ
罫	guaSS
冎	guaTQ
坬	guaTS
诖	guaY
詿	guaYQ
諣	guaYS
趏	guaZQ
踻	guaZS
贾	guB
痼	guBP
凅	guBQ
賈	guBS
蛄	guC
轱	guCP
蠱	guCQ
軱	guCS
軲	guCT
轂	guCU
沽	guE
汩	guEP
泒	guEQ
淈	guES
濲	guET
瀔	guEU
縎	guFQ
骨	guG
谷	guGC
鹘	guGD
鼓	guGP
鼔	guGQ
稒	guHQ
穀	guHS
梏	guI
摫	guiAQ
撌	guiAS
贵	guiB
皈	guiBC
宄	guiBD
癸	guiBP
貴	guiBQ
癐	guiBS
轨	guiC
軌	guiCQ
厬	guiCS
蛫	guiCT
螝	guiCU
蟡	guiCV
軓	guiCW
刽	guiD
刿	guiDP
劊	guiDQ
劌	guiDS
榾	guIE
氿	guiEQ
湀	guiES
溎	guiET
潙	guiEU
匦	guiF
匭	guiFQ
匱	guiFS
邽	guiFT
郌	guiFU
陒	guiFV
鬼	guiG
庋	guiGC
龟	guiGP
庪	guiGQ
廆	guiGS
鞼	guiGT
鬶	guiGU
鬹	guiGV
龜	guiGW
棝	guIH
桂	guiI
桧	guiIC
樻	guiIM
槼	guiIN
槻	guiIO
柜	guiIP
櫷	guiIQ
櫰	guiIS
櫃	guiIT
檜	guiIU
朹	guiIV
椝	guiIW
椢	guiIX
槣	guiIY
槶	guiIZ
规	guiJ
規	guiJQ
帰	guiJS
觤	guiJT
鐀	guiJU
鑎	guiJV
簋	guiK
筀	guiKQ
簂	guiKS
袿	guiKT
襘	guiKU
橭	guIL
胿	guiLQ
闺	guiM
閨	guiMQ
瞆	guiMS
瞡	guiMT
瞶	guiMU
騩	guiMV
妫	guiN
姽	guiNQ
媯	guiNS
嫢	guiNT
嬀	guiNU
鳺	guiNV
硅	guiP
硊	guiPQ
杚	guIQ
猤	guiQQ
炅	guiR
晷	guiRP
昋	guiRQ
柧	guIS
嶡	guiSQ
嶲	guiSS
巂	guiST
祪	guiSU
禬	guiSV
圭	guiT
垝	guiTQ
榖	guIU
茥	guiUQ
蓕	guiUS
蘬	guiUT
归	guiV
亀	guiVQ
佹	guiVS
瑰	guiW
珪	guiWQ
璝	guiWS
瓌	guiWT
櫎	guIX
恑	guiXQ
窐	guiXS
诡	guiY
鳜	guiYC
鲑	guiYP
詭	guiYQ
鮭	guiYS
鱖	guiYT
鱥	guiYU
跪	guiZ
攰	guiZQ
攱	guiZS
歸	guiZT
趹	guiZU
雟	guiZV
锢	guJ
觚	guJC
钴	guJP
鈲	guJQ
鈷	guJS
錮	guJT
箍	guK
笟	guKQ
箛	guKS
篐	guKT
股	guL
臌	guLP
脵	guLQ
蛊	guM
瞽	guMP
盬	guMQ
糓	guMS
姑	guN
鹄	guNC
輥	gunCQ
辊	gunCR
鸪	guND
滚	gunE
滾	gunEQ
绲	gunF
緄	gunFQ
緷	gunFS
棍	gunI
衮	gunK
袞	gunKQ
裷	gunKS
睔	gunMQ
牿	guNO
牯	guNP
硍	gunPQ
磙	gunPR
嫴	guNQ
鴣	guNS
鵠	guNT
鶻	guNU
蓘	gunUQ
蔉	gunUS
惃	gunXQ
鲧	gunY
謴	gunYQ
鮌	gunYS
鯀	gunYT
告	guO
掴	guoA
摑	guoAQ
馘	guoB
瘑	guoBQ
蝈	guoC
蜾	guoCP
蟈	guoCQ
輠	guoCS
淉	guoEQ
渦	guoES
漍	guoET
濄	guoEU
郭	guoF
聒	guoFP
綶	guoFQ
聝	guoFS
咕	guOG
彉	guoGQ
彍	guoGS
果	guoI
椁	guoIP
楇	guoIQ
槨	guoIS
櫎	guoIT
锅	guoJ
帼	guoJP
鍋	guoJQ
幗	guoJS
鈛	guoJT
鐹	guoJU
裹	guoK
簂	guoKQ
褁	guoKS
腂	guoLQ
腘	guoLS
膕	guoLT
矌	guoMQ
粿	guoMS
呙	guoO
咶	guoOQ
咼	guoOS
啯	guoOT
喐	guoOU
嘓	guoOV
古	guOP
唂	guOQ
猓	guoQR
唃	guOS
餜	guoSQ
崞	guoSR
馃	guoSS
啒	guOT
堝	guoTQ
埚	guoTR
墎	guoTS
嗗	guOU
蔮	guoUS
菓	guoUW
国	guoW
國	guoWQ
囯	guoWS
囶	guoWT
囻	guoWU
圀	guoWV
敋	guoWW
惈	guoXQ
慖	guoXS
懖	guoXT
过	guoZ
虢	guoZP
過	guoZQ
毂	guP
皷	guPQ
皼	guPS
磆	guPT
酤	guQ
崮	guS
嘏	guSC
罟	guSP
崓	guSQ
祻	guSS
罛	guST
餶	guSU
馉	guSV
堌	guTQ
菇	guU
菰	guUP
苽	guUQ
蓇	guUS
薣	guUT
估	guV
傦	guVQ
僱	guVS
故	guW
固	guWP
辜	guX
怘	guXQ
愲	guXS
顾	guY
鲴	guYC
诂	guYP
顧	guYQ
尳	guYS
羖	guYT
詁	guYU
鮕	guYV
鯝	guYW
孤	guZ
雇	guZP
夃	guZQ
逧	guZS
蛤	haC
蝦	haCQ
奤	haDQ
紦	haFQ
拸	haiAQ
害	haiB
海	haiE
絯	haiFQ
郂	haiFS
骸	haiG
烸	haiHQ
胲	haiL
浬	haiLQ
骇	haiM
駭	haiMQ
駴	haiMS
妎	haiNQ
嗨	haiO
咍	haiOQ
嗐	haiOS
嚡	haiOT
氦	haiQ
醢	haiQP
猲	haiQQ
酼	haiQS
餀	haiSQ
饚	haiSS
亥	haiT
塰	haiTQ
还	haiZ
孩	haiZP
還	haiZQ
铪	haJ
鉿	haJQ
撼	hanA
撖	hanAC
捍	hanAP
扞	hanAQ
寒	hanB
鼾	hanBP
兯	hanBQ
皔	hanBS
蚶	hanC
厈	hanCQ
虷	hanCS
蛿	hanCT
蜬	hanCU
蜭	hanCV
螒	hanCW
輚	hanCX
汉	hanE
涵	hanEC
瀚	hanED
汗	hanEP
漢	hanEQ
汵	hanES
浛	hanET
浫	hanEU
涆	hanEV
澏	hanEW
邯	hanF
邗	hanFP
貥	hangBQ
行	hangC
蚢	hangCQ
夯	hangD
沆	hangE
绗	hangF
斻	hangFQ
絎	hangFS
邟	hangFT
骯	hangGQ
杭	hangI
笐	hangKQ
筕	hangKS
裄	hangKT
妔	hangNQ
吭	hangO
甝	hanGQ
谽	hanGS
豃	hanGT
垳	hangTQ
苀	hangUQ
忼	hangXQ
颃	hangY
頏	hangYQ
魧	hangYS
航	hangZ
迒	hangZQ
焊	hanH
焓	hanHP
熯	hanHQ
梒	hanIQ
椷	hanIS
釬	hanJQ
銲	hanJS
鋎	hanJT
鋡	hanJU
函	hanK
凾	hanKQ
笒	hanKS
筨	hanKT
肣	hanLQ
罕	hanM
阚	hanMP
睅	hanMQ
閈	hanMS
闞	hanMT
闬	hanMU
馯	hanMV
駻	hanMW
娢	hanNQ
嫨	hanNS
鳱	hanNT
鶾	hanNU
含	hanO
喊	hanOP
哻	hanOQ
唅	hanOS
酣	hanQ
犴	hanQP
歛	hanQQ
猂	hanQS
旱	hanR
晗	hanRP
晘	hanRQ
暵	hanRS
屽	hanSQ
崡	hanSS
嵅	hanST
垾	hanTQ
菡	hanU
莟	hanUQ
蔊	hanUS
仠	hanVQ
佄	hanVS
傼	hanVT
韩	hanW
韓	hanWQ
圅	hanWS
攼	hanWT
琀	hanWU
憾	hanX
悍	hanXC
憨	hanXP
忓	hanXQ
馠	hanXS
翰	hanY
顸	hanYC
颔	hanYP
譀	hanYQ
頇	hanYS
頷	hanYT
顄	hanYU
魽	hanYV
爳	hanZQ
雗	hanZS
哈	haO
皓	haoB
皐	haoBQ
皜	haoBS
皞	haoBT
皡	haoBU
皥	haoBV
蚝	haoC
蠔	haoCQ
浩	haoE
灏	haoEC
濠	haoEP
淏	haoEQ
滈	haoES
滜	haoET
澔	haoEU
灝	haoEV
郝	haoF
聕	haoFQ
鄗	haoFS
號	haoHQ
秏	haoHS
椃	haoIQ
鎬	haoJQ
兞	haoKQ
籇	haoKS
耗	haoL
竓	haoLQ
毫	haoM
好	haoN
号	haoO
嗥	haoOC
嚆	haoOD
嚎	haoOP
呺	haoOQ
哠	haoOS
嘷	haoOT
噑	haoOU
獆	haoQQ
獋	haoQS
獔	haoQT
昊	haoR
昦	haoRQ
晧	haoRS
暠	haoRT
暤	haoRU
暭	haoRV
曍	haoRW
豪	haoS
壕	haoT
蒿	haoU
薅	haoUP
茠	haoUQ
薃	haoUS
薧	haoUT
藃	haoUU
乚	haoVQ
侴	haoVS
傐	haoVT
儫	haoVU
恏	haoXQ
悎	haoXS
颢	haoY
諕	haoYQ
譹	haoYS
顥	haoYT
鰝	haoYU
貉	haoZ
臯	haoZQ
乤	haYQ
抲	heAQ
贺	heB
賀	heBQ
寉	heBS
癋	heBT
皬	heBU
赫	heC
蚵	heCP
螛	heCQ
蠚	heCS
齕	heCT
龁	heCU
河	heE
涸	heEP
渮	heEQ
澕	heES
紇	heFQ
郃	heFS
鞨	heGQ
禾	heH
焃	heHQ
煂	heHS
熆	heHT
熇	heHU
燺	heHV
爀	heHW
核	heI
潶	heiEQ
黑	heiH
黒	heiHQ
嘿	heiO
柇	heIQ
楁	heIS
釛	heJQ
鉌	heJS
鑉	heJT
褐	heK
篕	heKQ
袔	heKS
劾	heL
盒	heM
阖	heMC
盍	heMD
阂	heMP
麧	heMQ
毼	heMS
盇	heMT
盉	heMU
籺	heMV
粭	heMW
閡	heMX
閤	heMY
闔	heMZ
鹤	heN
拫	henAQ
痕	henB
很	henC
撗	hengAQ
衡	hengC
鵆	hengCQ
涥	hengEQ
烆	hengHQ
横	hengI
桁	hengIP
橫	hengIQ
鑅	hengJQ
胻	hengLQ
脝	hengLS
姮	hengNQ
鴴	hengNS
鸻	hengNT
哼	hengO
啈	hengOQ
鞎	henGQ
亨	hengT
蘅	hengU
珩	hengW
恒	hengX
恆	hengXQ
悙	hengXS
噷	henOQ
狠	henQ
鶴	heNR
姀	heNS
鵠	heNT
鶡	heNU
鶮	heNV
佷	henVQ
鸖	heNW
恨	henX
穒	heNY
詪	henYQ
鹖	heNZ
和	heO
喝	heOC
呵	heOD
嗬	heOE
合	heOP
咊	heOQ
咼	heOS
哬	heOT
啝	heOU
喛	heOV
嗃	heOW
噈	heOX
嚇	heOY
碋	hePQ
礉	hePS
欱	heQQ
狢	heQS
猲	heQT
曷	heR
朅	heRQ
靍	heRS
靎	heRT
靏	heRU
峆	heSQ
餄	heSS
餲	heST
饸	heSU
壑	heT
垎	heTQ
荷	heU
菏	heUP
蓋	heUQ
萂	heUS
何	heV
佫	heVQ
敆	heWQ
惒	heXQ
覈	heXS
颌	heY
翮	heYC
诃	heYP
龢	heYQ
翯	heYS
訶	heYT
訸	heYU
詥	heYV
謞	heYW
頜	heYX
魺	heYY
鲄	heYZ
貉	heZ
貈	heZQ
隺	heZS
揈	hongAQ
撔	hongAS
宏	hongB
黉	hongBC
訇	hongBP
宖	hongBQ
轰	hongC
虹	hongCP
轟	hongCQ
軣	hongCS
輷	hongCT
鬨	hongDQ
洪	hongE
泓	hongEP
澒	hongEQ
汯	hongES
沗	hongET
浤	hongEU
浲	hongEV
渱	hongEW
渹	hongEX
溄	hongEY
潂	hongEZ
红	hongF
紅	hongFQ
紘	hongFS
紭	hongFT
綋	hongFU
纮	hongFV
耾	hongFW
弘	hongG
彋	hongGQ
谹	hongGS
谼	hongGT
谾	hongGU
鞃	hongGV
烘	hongH
灴	hongHQ
焢	hongHS
黌	hongHT
鈜	hongJQ
鉷	hongJS
銾	hongJT
鋐	hongJU
鍧	hongJV
篊	hongKQ
竑	hongLQ
竤	hongLS
闳	hongM
粠	hongMQ
閎	hongMS
閧	hongMT
闀	hongMU
闂	hongMV
鸿	hongN
鴻	hongNQ
妅	hongNS
娂	hongNT
哄	hongO
叿	hongOQ
吰	hongOS
吽	hongOT
呍	hongOU
唝	hongOV
嗊	hongOW
嚝	hongOX
硔	hongPQ
硡	hongPS
晎	hongRQ
霐	hongRS
霟	hongRT
厷	hongSQ
屸	hongSS
巆	hongST
垬	hongTQ
薨	hongU
蕻	hongUC
荭	hongUP
苰	hongUQ
葒	hongUS
葓	hongUT
仜	hongVQ
玒	hongWQ
玜	hongWS
瓨	hongWT
愩	hongXQ
慐	hongXS
讧	hongY
羾	hongYQ
翃	hongYS
翝	hongYT
訌	hongYU
魟	hongYV
瘊	houB
齁	houBQ
厚	houC
後	houCP
洉	houEQ
郈	houFQ
鄇	houFS
骺	houG
帿	houJQ
銗	houJS
鍭	houJT
篌	houK
糇	houM
睺	houMQ
后	houO
吼	houOC
喉	houOP
吽	houOQ
呴	houOS
猴	houQ
犼	houQQ
豞	houQS
矦	houSQ
餱	houSS
堠	houT
垕	houTQ
茩	houUQ
葔	houUS
候	houV
侯	houVP
鲎	houY
翭	houYQ
翵	houYS
鮜	houYT
鯸	houYU
鱟	houYV
鲘	houYW
逅	houZ
护	huA
搳	huaAQ
摦	huaAS
撶	huaAT
螖	huaCQ
划	huaD
劃	huaDQ
夻	huaDS
滑	huaE
澅	huaEQ
繣	huaFQ
搰	huAG
摢	huAH
黊	huaHQ
桦	huaI
徊	huaiC
劃	huaiDQ
淮	huaiE
瀤	huaiEQ
槐	huaiI
櫰	huaiIQ
褢	huaiKQ
褱	huaiKS
耲	huaiLQ
咶	huaiOQ
樺	huaIQ
杹	huaIS
坏	huaiT
壞	huaiTQ
壊	huaiTS
椛	huaIU
蘹	huaiUQ
蘾	huaiUS
槬	huaIV
佪	huaiVQ
枠	huaIW
怀	huaiX
懷	huaiXQ
懐	huaiXS
踝	huaiZ
铧	huaJ
觟	huaJQ
釪	huaJS
釫	huaJT
鋘	huaJU
錵	huaJV
鏵	huaJW
骅	huaM
糀	huaMQ
驊	huaMS
换	huanA
擐	huanAC
換	huanAQ
攌	huanAS
寰	huanB
宦	huanBC
鬟	huanBD
痪	huanBP
瘓	huanBQ
寏	huanBS
轘	huanCQ
奂	huanD
奐	huanDQ
涣	huanE
洹	huanEC
漶	huanED
浣	huanEP
渙	huanEQ
澣	huanES
澴	huanET
缓	huanF
缳	huanFC
郇	huanFP
緩	huanFQ
絙	huanFS
綄	huanFT
繯	huanFU
酄	huanFV
揘	huangAQ
皇	huangB
癀	huangBP
宺	huangBQ
皝	huangBS
皩	huangBT
蝗	huangC
蟥	huangCC
徨	huangCP
巟	huangCQ
奛	huangDQ
潢	huangE
湟	huangEP
兤	huangEQ
汻	huangES
滉	huangET
隍	huangF
縨	huangFQ
黄	huangH
煌	huangHP
黃	huangHQ
炾	huangHS
熀	huangHT
熿	huangHU
爌	huangHV
穔	huangHW
楻	huangIQ
榥	huangIS
櫎	huangIT
凰	huangJ
幌	huangJP
鍠	huangJQ
鎤	huangJS
鐄	huangJT
锽	huangJU
簧	huangK
篁	huangKP
肓	huangL
朚	huangLQ
騜	huangMQ
媓	huangNQ
鷬	huangNS
喤	huangOQ
磺	huangP
獚	huangQQ
晃	huangR
晄	huangRQ
曂	huangRS
崲	huangSQ
餭	huangSS
堭	huangTQ
塃	huangTS
墴	huangTT
荒	huangU
葟	huangUQ
偟	huangVQ
璜	huangW
瑝	huangWQ
慌	huangX
恍	huangXC
惶	huangXP
怳	huangXQ
愰	huangXS
衁	huangXT
谎	huangY
鳇	huangYP
謊	huangYQ
詤	huangYS
諻	huangYT
韹	huangYU
鰉	huangYV
鱑	huangYW
遑	huangZ
艎	huangZQ
趪	huangZS
焕	huanH
煥	huanHQ
烉	huanHS
梙	huanIQ
槵	huanIS
锾	huanJ
鍰	huanJQ
鐶	huanJS
镮	huanJT
肒	huanLQ
桓	huanM
睆	huanMQ
瞏	huanMS
糫	huanMT
闤	huanMU
阛	huanMV
驩	huanMW
嬛	huanNQ
孉	huanNS
鴅	huanNT
鵍	huanNU
鹮	huanNV
唤	huanO
喚	huanOQ
喛	huanOS
嚾	huanOT
欢	huanQ
獾	huanQP
歡	huanQQ
姡	huaNQR
歓	huanQS
犿	huanQT
狟	huanQU
獂	huanQV
豲	huanQW
婲	huaNS
峘	huanSQ
嵈	huanSS
婳	huaNT
堚	huanTQ
萑	huanU
荁	huanUQ
嫿	huaNUR
萈	huanUS
蒝	huanUT
藧	huanUU
嬅	huaNV
环	huanW
圜	huanWP
環	huanWQ
鷨	huaNWR
瑍	huanWS
瓛	huanWT
患	huanX
愌	huanXQ
懁	huanXS
懽	huanXT
幻	huanY
鲩	huanYP
羦	huanYQ
讙	huanYS
鯇	huanYT
鯶	huanYU
鰀	huanYV
还	huanZ
逭	huanZC
豢	huanZP
還	huanZQ
貆	huanZS
貛	huanZT
雈	huanZU
雚	huanZV
哗	huaO
嘩	huaOQ
吪	huaOS
呚	huaOT
砉	huaP
硴	huaPQ
磆	huaPS
猾	huaQ
抇	huAR
华	huaS
崋	huaSQ
舙	huaSS
画	huaT
畫	huaTQ
埖	huaTS
畵	huaTT
花	huaU
華	huaUQ
芲	huaUS
蕐	huaUT
蘤	huaUU
化	huaV
话	huaY
話	huaYQ
誮	huaYS
諙	huaYT
諣	huaYU
譁	huaYV
譮	huaYW
鮭	huaYX
冱	huB
寣	huBQ
鬍	huBS
蝴	huC
轷	huCP
螜	huCQ
軤	huCS
湖	huE
浒	huEC
滹	huED
沪	huEP
滬	huEQ
瀫	huES
汻	huET
沍	huEU
泘	huEV
淲	huEW
淴	huEX
滸	huEY
濩	huEZ
匢	huFQ
匫	huFS
絗	huFT
綔	huFU
縎	huFV
縠	huFW
鄠	huFX
弧	huG
鹘	huGC
瓠	huGP
弖	huGQ
戯	huGS
戱	huGT
戲	huGU
瓡	huGV
互	huH
虎	huHC
扈	huHD
烀	huHE
煳	huHF
戽	huHG
户	huHP
戶	huHQ
戸	huHS
焀	huHT
熩	huHU
虖	huHV
虝	huHW
虍	huHX
槲	huI
挥	huiA
揮	huiAQ
拻	huiAS
撝	huiAT
贿	huiB
賄	huiBQ
寭	huiBS
痐	huiBT
瘣	huiBU
辉	huiC
蛔	huiCC
虺	huiCD
蟪	huiCE
徽	huiCP
輝	huiCQ
徻	huiCS
蚘	huiCT
蛕	huiCU
蜖	huiCV
螝	huiCW
蟲	huiCX
殨	huiDQ
汇	huiE
洄	huiEP
瀈	huiEQ
泋	huiES
洃	huiET
湏	huiEU
滙	huiEV
潓	huiEW
潰	huiEX
澮	huiEY
濊	huiEZ
绘	huiF
缋	huiFP
匯	huiFQ
繪	huiFS
絵	huiFT
繢	huiFU
隓	huiFV
廆	huiGQ
戯	huiGS
戲	huiGT
灰	huiH
烩	huiHC
秽	huiHP
穢	huiHQ
灳	huiHS
烠	huiHT
烣	huiHU
煇	huiHV
煒	huiHW
燬	huiHX
燴	huiHY
桧	huiI
椲	huiIQ
楎	huiIS
槥	huiIT
橞	huiIU
檅	huiIV
檓	huiIW
檜	huiIX
櫘	huiIY
幑	huiJQ
銊	huiJS
鏸	huiJT
鐬	huiJU
篲	huiKQ
袆	huiKS
褘	huiKT
麾	huiM
睳	huiMQ
瞺	huiMS
闠	huiMT
阓	huiMU
靧	huiMV
槴	huIN
婎	huiNQ
媈	huiNS
嬒	huiNT
孈	huiNU
喙	huiO
咴	huiOP
嘒	huiOQ
噅	huiOS
噕	huiOT
噦	huiOU
嚖	huiOV
毁	huiP
毀	huiPQ
毇	huiPS
枑	huIQ
獩	huiQQ
豗	huiQS
晦	huiR
晖	huiRP
會	huiRQ
暉	huiRS
暳	huiRT
卉	huiS
叀	huiSQ
屶	huiSS
屷	huiST
禈	huiSU
餯	huiSV
楜	huIT
墮	huiTQ
囘	huiTS
荟	huiU
茴	huiUC
蕙	huiUP
芔	huiUQ
蔧	huiUS
薈	huiUT
薉	huiUU
藱	huiUV
蘳	huiUW
会	huiV
佪	huiVQ
僡	huiVS
儶	huiVT
回	huiW
珲	huiWP
囬	huiWQ
圚	huiWS
琿	huiWT
璤	huiWU
璯	huiWV
恢	huiX
惠	huiXC
悔	huiXD
彗	huiXE
隳	huiXF
恚	huiXG
慧	huiXP
彙	huiXQ
彚	huiXS
恛	huiXT
恵	huiXU
憓	huiXV
懳	huiXW
讳	huiY
诲	huiYC
詼	huiYG
詯	huiYH
翽	huiYI
翬	huiYJ
翚	huiYK
翙	huiYL
廽	huiYM
廻	huiYN
譓	huiYO
诙	huiYP
諱	huiYQ
誨	huiYS
鮰	huiYT
鰴	huiYU
颒	huiYV
顪	huiYW
頮	huiYX
譿	huiYY
譭	huiYZ
楛	huIZ
迴	huiZQ
逥	huiZS
斛	huJ
帍	huJQ
幠	huJS
觷	huJT
錿	huJU
鍙	huJV
鍸	huJW
笏	huK
箶	huKQ
簄	huKS
胡	huL
膴	huLQ
糊	huM
粐	huMQ
鹄	huN
掍	hunAQ
鹱	huNC
轋	hunCQ
殙	hunDQ
混	hunE
溷	hunEC
浑	hunEP
渾	hunEQ
涽	hunES
湣	hunET
湷	hunEU
嫭	huNF
魂	hunG
尡	hunGQ
鶦	huNH
焄	hunHQ
焝	hunHS
鶻	huNI
棔	hunIQ
觨	hunJQ
婟	huNK
鵠	huNL
鶘	huNM
眃	hunMQ
阍	hunMR
睧	hunMS
睯	hunMT
睴	hunMU
閽	hunMV
婚	hunN
婫	hunNQ
鳸	huNO
鹕	huNP
鸌	huNQ
昏	hunR
昬	hunRQ
馄	hunS
餛	hunSQ
餫	hunSS
鼲	hunST
鶮	huNT
荤	hunU
葷	hunUQ
蔒	hunUS
姱	huNV
俒	hunVQ
倱	hunVS
珲	hunW
圂	hunWQ
琿	hunWS
媩	huNX
忶	hunXQ
惛	hunXS
惽	hunXT
慁	hunXU
诨	hunY
諢	hunYQ
嫮	huNZ
和	huO
攉	huoA
捇	huoAQ
掝	huoAS
擭	huoAT
货	huoB
貨	huoBQ
癨	huoBS
唬	huOC
蠖	huoCR
唿	huOD
剨	huoDQ
劐	huoDR
奯	huoDS
活	huoE
沎	huoEQ
湱	huoES
漷	huoET
濊	huoEU
濩	huoEV
瀖	huoEW
嘑	huOF
邩	huoFQ
或	huoG
豁	huoGP
韄	huoGQ
火	huoH
煷	huoHQ
秮	huoHS
秳	huoHT
秴	huoHU
穫	huoHV
灬	huoHW
嗃	huOI
檴	huoIQ
镬	huoJ
钬	huoJC
锪	huoJP
旤	huoJQ
鈥	huoJS
鍃	huoJT
鑊	huoJU
篧	huoKQ
耠	huoL
耯	huoLQ
臛	huoLS
眓	huoMQ
矆	huoMS
矐	huoMT
閄	huoMU
騞	huoMV
姡	huoNQ
和	huoO
嚯	huoOP
吙	huoOQ
咊	huoOS
咟	huoOT
喐	huoOU
嚄	huoOV
嚿	huoOW
呼	huOP
乊	huoPQ
礊	huoPS
咊	huOQ
獲	huoQQ
霍	huoR
曤	huoRQ
靃	huoRS
祸	huoS
禍	huoSQ
嗀	huOT
获	huoU
藿	huoUP
蒦	huoUS
伙	huoV
佸	huoVQ
俰	huoVS
嘝	huOW
惑	huoX
夥	huoXP
彟	huoXQ
彠	huoXS
窢	huoXT
嚛	huOY
謋	huoYQ
喖	huOZ
艧	huoZQ
趏	huoZS
雘	huoZT
乎	huP
觳	huPP
乕	huPQ
礐	huPS
狐	huQ
猢	huQC
醐	huQP
歑	huQQ
豰	huQS
昈	huRQ
昒	huRS
曶	huRT
雽	huRU
壶	huS
岵	huSC
祜	huSP
壺	huSQ
壷	huSS
餬	huST
垀	huTQ
葫	huU
芐	huUQ
芔	huUS
苸	huUT
萀	huUU
蔛	huUV
蔰	huUW
俿	huVQ
僱	huVS
瑚	huW
囫	huWC
琥	huWP
瓳	huWQ
忽	huX
怙	huXC
惚	huXP
怘	huXQ
恗	huXS
衚	huXT
乯	huYI
鯱	huYO
護	huYQ
鳠	huYS
許	huYT
謼	huYU
頀	huYV
頶	huYW
魱	huYX
鰗	huYY
鱯	huYZ
隺	huZQ
雐	huZS
技	jiA
扴	jiaAQ
抸	jiaAS
拁	jiaAT
挾	jiaAU
擖	jiaAV
家	jiaB
痂	jiaBC
瘕	jiaBD
贾	jiaBP
賈	jiaBQ
宊	jiaBS
掎	jiAC
徍	jiaCQ
蛱	jiaCR
徦	jiaCS
蛺	jiaCT
夹	jiaD
夾	jiaDQ
斚	jiaDS
斝	jiaDT
浃	jiaE
泇	jiaEQ
浹	jiaES
郏	jiaF
郟	jiaFQ
纐	jiaFS
戛	jiaG
戞	jiaGQ
稼	jiaH
架	jiaI
梜	jiaIQ
椵	jiaIS
榎	jiaIT
榢	jiaIU
槚	jiaIV
檟	jiaIW
钾	jiaJ
铗	jiaJC
镓	jiaJP
鉀	jiaJQ
幏	jiaJS
鉫	jiaJT
鋏	jiaJU
鎵	jiaJV
袈	jiaK
笳	jiaKP
筴	jiaKQ
裌	jiaKS
加	jiaL
胛	jiaLP
耞	jiaLQ
脥	jiaLS
腵	jiaLT
麚	jiaLU
驾	jiaM
枷	jiaMP
駕	jiaMQ
毠	jiaMS
糘	jiaMT
嫁	jiaN
拣	jianA
搛	jianAC
捡	jianAP
揀	jianAQ
撿	jianAS
挸	jianAT
揃	jianAU
揵	jianAV
擶	jianAW
攕	jianAX
减	jianB
贱	jianBC
謇	jianBD
蹇	jianBE
兼	jianBP
賤	jianBQ
冿	jianBS
寋	jianBT
賎	jianBU
鬋	jianBV
徤	jianCQ
螹	jianCS
蠒	jianCT
轞	jianCU
剪	jianD
歼	jianDC
剑	jianDP
劍	jianDQ
殲	jianDS
剣	jianDT
剱	jianDU
劎	jianDV
劒	jianDW
劔	jianDX
殱	jianDY
渐	jianE
涧	jianEC
湔	jianED
瀐	jianEN
湕	jianEO
溅	jianEP
減	jianEQ
漸	jianES
澗	jianET
濺	jianEU
瀽	jianEV
瀸	jianEW
瀳	jianEX
洊	jianEY
淺	jianEZ
缄	jianF
缣	jianFP
繭	jianFQ
旔	jianFS
絸	jianFT
緘	jianFU
縑	jianFV
繝	jianFW
聻	jianFX
艰	jianG
摪	jiangAQ
摾	jiangAS
鞯	jianGC
將	jiangCQ
螀	jiangCS
螿	jiangCT
奖	jiangD
豇	jiangDP
奨	jiangDQ
戬	jianGDR
奬	jiangDS
殭	jiangDT
江	jiangE
洚	jiangEC
浆	jiangEP
漿	jiangEQ
滰	jiangES
降	jiangF
缰	jiangFC
绛	jiangFD
匠	jiangFP
匞	jiangFQ
絳	jiangFS
繮	jiangFT
强	jiangG
韁	jiangGQ
弜	jiangGS
弶	jiangGT
強	jiangGU
彊	jiangGV
桨	jiangI
槳	jiangIQ
橿	jiangIS
櫤	jiangIT
耩	jiangL
勥	jiangLQ
膙	jiangLS
糨	jiangM
糡	jiangMQ
姜	jiangN
犟	jiangNP
将	jiangP
礓	jiangPP
戋	jianGPR
酱	jiangQ
靓	jiangQP
獎	jiangQQ
韉	jianGQR
醬	jiangQS
醤	jiangQT
嵹	jiangSQ
幵	jianGSR
疆	jiangT
塂	jiangTQ
弿	jianGTR
壃	jiangTS
畕	jiangTT
畺	jiangTU
疅	jiangTV
蒋	jiangU
茳	jiangUP
蔣	jiangUQ
彅	jianGUR
薑	jiangUS
葁	jiangUT
僵	jiangV
傋	jiangVQ
戔	jianGVR
戩	jianGW
靬	jianGX
讲	jiangY
講	jiangYQ
鞬	jianGYR
翞	jiangYS
謽	jiangYT
顜	jiangYU
鱂	jiangYV
鳉	jiangYW
韀	jianGZ
夅	jiangZQ
煎	jianH
熞	jianHQ
熸	jianHS
稴	jianHT
检	jianI
槛	jianIC
枧	jianID
楗	jianIE
橏	jianIN
樫	jianIO
柬	jianIP
檢	jianIQ
櫼	jianIS
檻	jianIT
栫	jianIU
梘	jianIV
検	jianIW
椷	jianIX
椾	jianIY
榗	jianIZ
见	jianJ
鉴	jianJC
锏	jianJD
帴	jianJJ
鑬	jianJM
鑑	jianJN
鐱	jianJO
键	jianJP
見	jianJQ
鍵	jianJS
鐧	jianJSR
鐗	jianJT
鑯	jianJTR
覵	jianJU
鍳	jianJUR
鋻	jianJV
覸	jianJVR
鑒	jianJW
釰	jianJWR
釼	jianJX
鑳	jianJXR
鋄	jianJY
鎫	jianJYR
鋑	jianJZ
鏩	jianJZR
简	jianK
笕	jianKC
裥	jianKD
襇	jianKO
箭	jianKP
簡	jianKQ
襺	jianKS
襉	jianKT
筧	jianKU
箋	jianKV
篯	jianKW
籈	jianKX
籛	jianKY
袸	jianKZ
肩	jianL
腱	jianLP
鹼	jianLQ
鹸	jianLS
鹹	jianLT
鹻	jianLU
麉	jianLV
间	jianM
睑	jianMC
毽	jianMD
监	jianMP
監	jianMQ
間	jianMS
睷	jianMT
瞯	jianMU
瞷	jianMV
瞼	jianMW
糋	jianMX
閒	jianMY
奸	jianN
鹣	jianNC
牮	jianND
犍	jianNP
姦	jianNQ
姧	jianNS
鳽	jianNT
鵑	jianNU
鵳	jianNV
鶼	jianNW
囏	jianOQ
碱	jianP
硷	jianPP
牋	jianPQ
碊	jianPS
磵	jianPT
礀	jianPU
礆	jianPV
礛	jianPW
礷	jianPX
猏	jianQQ
婽	jiaNQR
豜	jianQS
豣	jianQT
暕	jianRQ
朁	jianRS
饯	jianS
餞	jianSQ
犌	jiaNSR
餰	jianSS
坚	jianT
堅	jianTQ
鴐	jiaNTR
堿	jianTS
塹	jianTT
墹	jianTU
荐	jianU
菅	jianUC
蒹	jianUD
茧	jianUP
薦	jianUQ
鴶	jiaNUR
菺	jianUS
葌	jianUT
蔪	jianUU
蕑	jianUV
蕳	jianUW
藆	jianUX
虃	jianUY
件	jianV
俭	jianVC
僭	jianVD
健	jianVP
儉	jianVQ
鵊	jiaNVR
俴	jianVS
倹	jianVT
傔	jianVU
僣	jianVV
囝	jianW
玪	jianWQ
珔	jianWS
瑊	jianWT
瑐	jianWU
尖	jianX
惤	jianXQ
馢	jianXS
建	jianY
翦	jianYC
鲣	jianYD
谫	jianYE
鰎	jianYM
譾	jianYN
譼	jianYO
谏	jianYP
鳒	jianYQ
鰹	jianYS
鰜	jianYT
鰔	jianYU
詃	jianYV
諓	jianYW
諫	jianYX
謭	jianYY
譛	jianYZ
践	jianZ
笺	jianZC
踺	jianZD
舰	jianZP
艦	jianZQ
艱	jianZS
踐	jianZT
臶	jianZU
趝	jianZV
跈	jianZW
雃	jianZX
嘉	jiaO
搅	jiaoA
挢	jiaoAP
攪	jiaoAQ
挍	jiaoAS
捁	jiaoAT
摎	jiaoAU
摷	jiaoAV
撟	jiaoAW
撹	jiaoAX
皎	jiaoB
癄	jiaoBQ
皦	jiaoBS
皭	jiaoBT
賋	jiaoBU
较	jiaoC
蛟	jiaoCC
徼	jiaoCD
轿	jiaoCP
較	jiaoCQ
轎	jiaoCS
徺	jiaoCT
蟜	jiaoCU
蟭	jiaoCV
轇	jiaoCW
剿	jiaoD
劋	jiaoDQ
斠	jiaoDS
浇	jiaoE
湫	jiaoEP
澆	jiaoEQ
湬	jiaoES
滘	jiaoET
漖	jiaoEU
潐	jiaoEV
灂	jiaoEW
灚	jiaoEX
郊	jiaoF
绞	jiaoFC
缴	jiaoFP
絞	jiaoFQ
繳	jiaoFS
焦	jiaoH
烄	jiaoHQ
煍	jiaoHS
燋	jiaoHT
穚	jiaoHU
虠	jiaoHV
校	jiaoI
椒	jiaoIP
樔	jiaoIQ
角	jiaoJC
铰	jiaoJD
覺	jiaoJQ
覐	jiaoJS
覚	jiaoJT
釥	jiaoJU
鉸	jiaoJV
鐎	jiaoJW
笅	jiaoKQ
筊	jiaoKS
簥	jiaoKT
脚	jiaoL
胶	jiaoLP
腳	jiaoLQ
膠	jiaoLS
勦	jiaoLT
膲	jiaoLU
骄	jiaoM
驕	jiaoMQ
娇	jiaoN
鹪	jiaoNC
姣	jiaoNP
嬌	jiaoNQ
嬓	jiaoNS
孂	jiaoNT
鵁	jiaoNU
鷦	jiaoNV
鷮	jiaoNW
叫	jiaoO
噍	jiaoOC
嚼	jiaoOP
呌	jiaoOQ
喬	jiaoOS
嘂	jiaoOT
嘄	jiaoOU
嘐	jiaoOV
嘦	jiaoOW
噭	jiaoOX
礁	jiaoP
狡	jiaoQ
醮	jiaoQC
酵	jiaoQP
獥	jiaoQQ
唊	jiaOQR
釂	jiaoQS
晈	jiaoRQ
暞	jiaoRS
曒	jiaoRT
矫	jiaoS
峤	jiaoSC
饺	jiaoSP
矯	jiaoSQ
餃	jiaoSS
峧	jiaoST
嶕	jiaoSU
嶠	jiaoSV
嶣	jiaoSW
交	jiaoT
蕉	jiaoU
艽	jiaoUC
茭	jiaoUP
茮	jiaoUQ
藠	jiaoUS
佼	jiaoV
僬	jiaoVC
侥	jiaoVP
僥	jiaoVQ
儌	jiaoVS
教	jiaoW
敫	jiaoWP
敎	jiaoWQ
敽	jiaoWS
敿	jiaoWT
斍	jiaoWU
珓	jiaoWV
璬	jiaoWW
窖	jiaoX
恔	jiaoXQ
悎	jiaoXS
憍	jiaoXT
憢	jiaoXU
憿	jiaoXV
窌	jiaoXW
鲛	jiaoY
訆	jiaoYQ
譑	jiaoYS
譥	jiaoYT
鮫	jiaoYU
鱎	jiaoYV
龣	jiaoYW
跤	jiaoZ
臫	jiaoZQ
趭	jiaoZS
踋	jiaoZT
挤	jiAP
擊	jiAQ
猰	jiaQQ
猳	jiaQS
豭	jiaQT
撃	jiAR
擠	jiAS
岬	jiaSR
揤	jiAT
甲	jiaTA
圿	jiaTQ
埉	jiaTS
摖	jiAU
茄	jiaUA
葭	jiaUC
荚	jiaUP
莢	jiaUQ
价	jiaV
佳	jiaVC
伽	jiaVD
假	jiaVP
價	jiaVQ
傢	jiaVS
撠	jiAW
珈	jiaWA
玾	jiaWQ
撽	jiAX
忦	jiaXQ
恝	jiaXR
颊	jiaY
乫	jiaYI
頰	jiaYQ
叚	jiaYS
頡	jiaYT
頬	jiaYU
嗧	jiaYV
迦	jiaZ
跏	jiaZP
貑	jiaZQ
跲	jiaZS
寄	jiB
寂	jiBC
冀	jiBD
髻	jiBE
瘠	jiBF
赍	jiBG
疾	jiBP
兾	jiBQ
痵	jiBS
癠	jiBT
癪	jiBU
皀	jiBV
皍	jiBW
賫	jiBX
賷	jiBY
辑	jiC
虮	jiCP
輯	jiCQ
彶	jiCS
徛	jiCT
蝍	jiCU
螏	jiCV
蟣	jiCW
轚	jiCX
剂	jiD
殛	jiDC
剞	jiDP
劑	jiDQ
刉	jiDS
刏	jiDT
剤	jiDU
济	jiE
接	jieA
捷	jieAC
拮	jieAD
揭	jieAP
扢	jieAQ
掲	jieAS
掶	jieAT
搩	jieAU
擑	jieAV
擮	jieAW
擳	jieAX
皆	jieB
疖	jieBC
疥	jieBP
痎	jieBQ
癤	jieBS
镼	jieBT
街	jieC
蚧	jieCP
徣	jieCQ
蛣	jieCS
蛶	jieCT
蜐	jieCU
蝔	jieCV
蠘	jieCW
蠞	jieCX
蠽	jieCY
洎	jiED
刦	jieDQ
刧	jieDS
刼	jieDT
洁	jieE
潔	jieEQ
湝	jieES
洯	jieET
滐	jieEU
结	jieF
阶	jieFP
結	jieFQ
階	jieFS
斺	jieFT
紒	jieFU
絜	jieFV
截	jieG
骱	jieGC
戒	jieGP
庎	jieGQ
鞂	jieGS
鞊	jieGT
秸	jieH
煯	jieHQ
稭	jieHS
杰	jieI
桀	jieIC
桔	jieIP
杢	jieIQ
桝	jieIS
椄	jieIT
楐	jieIU
楬	jieIV
楶	jieIW
榤	jieIX
檞	jieIY
解	jieJ
卪	jieJQ
幯	jieJS
觧	jieJT
卩	jieJU
鉣	jieJV
鍻	jieJW
鎅	jieJX
汲	jiEK
節	jieKQ
衱	jieKS
衸	jieKT
袓	jieKU
袺	jieKV
裓	jieKW
褯	jieKX
竭	jieL
劫	jieLP
丯	jieLQ
劼	jieLS
耤	jieLT
脻	jieLU
睫	jieM
毑	jieMQ
潗	jiEN
姐	jieNA
婕	jieNP
妎	jieNQ
媎	jieNS
媘	jieNT
媫	jieNU
嫅	jieNV
犗	jieNW
鶛	jieNX
鶡	jieNY
漈	jiEO
嗟	jieOA
喈	jieOP
吤	jieOQ
唶	jieOS
啑	jieOT
喼	jieOU
嚌	jieOV
激	jiEP
届	jiePA
碣	jiePP
屆	jiePQ
砎	jiePS
礍	jiePT
濟	jiEQ
狤	jieQQ
濈	jiER
昅	jieRQ
瀱	jiES
嶻	jieSO
飷	jieSQ
巀	jieSS
岊	jieST
岕	jieSU
崨	jieSV
嵑	jieSW
嵥	jieSX
嶰	jieSY
嶱	jieSZ
界	jieT
堦	jieTQ
堺	jieTS
畍	jieTT
汥	jiEU
节	jieUA
芥	jieUC
藉	jieUP
莭	jieUQ
菨	jieUS
蓵	jieUT
泲	jiEV
介	jieVA
借	jieVP
傑	jieVQ
倢	jieVS
偼	jieVT
價	jieVU
淁	jiEW
玠	jieWQ
琾	jieWS
瑎	jieWT
済	jiEX
尐	jieXQ
悈	jieXS
湒	jiEY
诫	jieYA
颉	jieYC
羯	jieYD
鲒	jieYE
讦	jieYF
诘	jieYP
誡	jieYQ
訐	jieYS
詰	jieYT
誱	jieYU
謯	jieYV
頡	jieYW
魪	jieYX
鮚	jieYY
漃	jiEZ
疌	jieZQ
孑	jieZR
趌	jieZS
跲	jieZT
踕	jieZU
迼	jieZV
级	jiF
纪	jiFC
继	jiFD
绩	jiFE
缉	jiFF
系	jiFG
给	jiFH
緝	jiFJ
緁	jiFK
綨	jiFL
継	jiFM
紒	jiFN
繋	jiFO
际	jiFP
際	jiFQ
繼	jiFS
績	jiFT
紀	jiFU
級	jiFV
給	jiFW
隮	jiFX
郆	jiFY
繫	jiFZ
既	jiG
戟	jiGC
戢	jiGD
暨	jiGP
庴	jiGQ
廭	jiGS
谻	jiGT
鞊	jiGU
鞿	jiGV
鬾	jiGW
魕	jiGX
积	jiH
稷	jiHC
嵇	jiHD
稽	jiHP
積	jiHQ
丌	jiHS
焏	jiHT
稘	jiHU
稩	jiHV
穄	jiHW
穊	jiHX
穖	jiHY
穧	jiHZ
机	jiI
棘	jiIC
楫	jiID
樭	jiIK
槣	jiIL
槉	jiIM
楖	jiIN
梞	jiIO
极	jiIP
極	jiIQ
機	jiIS
櫭	jiIT
櫅	jiIU
檵	jiIV
檝	jiIW
檕	jiIX
橶	jiIY
枅	jiIZ
几	jiJ
即	jiJC
觊	jiJD
銈	jiJI
觭	jiJJ
觙	jiJK
覬	jiJL
旣	jiJM
旡	jiJN
帺	jiJO
己	jiJP
韲	jiJQ
鑙	jiJS
鑇	jiJT
鐖	jiJU
鏶	jiJV
鍓	jiJW
錤	jiJX
銡	jiJY
卽	jiJZ
击	jiK
箕	jiKC
笈	jiKD
笄	jiKE
籍	jiKP
筓	jiKQ
箿	jiKS
簊	jiKT
簎	jiKU
裚	jiKV
襀	jiKW
襋	jiKX
肌	jiL
麂	jiLC
脊	jiLP
丮	jiLQ
勣	jiLS
朞	jiLT
耤	jiLU
耭	jiLV
膌	jiLW
骑	jiM
骥	jiMP
瞉	jiMQ
驥	jiMS
鸡	jiN
鶏	jina
搢	jinAQ
赆	jinB
凚	jinBQ
寖	jinBS
賮	jinBT
贐	jinBU
姬	jiNC
厪	jinCQ
齽	jinCS
妓	jiND
殣	jinDQ
犄	jiNE
津	jinEA
浸	jinEP
兓	jinEQ
巹	jinES
浕	jinET
溍	jinEU
漌	jinEV
濅	jinEW
濜	jinEX
紧	jinF
缙	jinFP
緊	jinFQ
紟	jinFS
縉	jinFT
靳	jinG
擏	jingAQ
净	jingB
痉	jingBP
凈	jingBQ
宑	jingBS
痙	jingBT
径	jingC
徑	jingCQ
巠	jingCS
蟼	jingCT
刭	jingDP
剄	jingDQ
殌	jingDS
殑	jingDT
兢	jingE
泾	jingEP
汫	jingEQ
汬	jingES
浄	jingET
涇	jingEU
淨	jingEV
澋	jingEW
瀞	jingEX
经	jingF
旌	jingFC
阱	jingFP
經	jingFQ
旍	jingFS
経	jingFT
綡	jingFU
聙	jingFV
弪	jingGP
弳	jingGQ
井	jingH
秔	jingHQ
稉	jingHS
桱	jingIQ
梷	jingIS
橸	jingIT
镜	jingJ
鏡	jingJQ
幜	jingJS
鋞	jingJT
箐	jingK
竟	jingL
胫	jingLC
腈	jingLD
肼	jingLE
竞	jingLP
勁	jingLQ
競	jingLS
麠	jingLT
劤	jingLU
竧	jingLV
竫	jingLW
竸	jingLX
脛	jingLY
麖	jingLZ
精	jingM
粳	jingMC
睛	jingMP
驚	jingMQ
粇	jingMS
婧	jingNP
妌	jingNQ
婙	jingNS
婛	jingNT
鵛	jingNU
鶁	jingNV
鶄	jingNW
廑	jinGPR
静	jingQ
獍	jingQC
靖	jingQP
靜	jingQQ
猄	jingQS
靚	jingQT
景	jingR
晶	jingRP
暻	jingRQ
曔	jingRS
鼱	jingSQ
境	jingT
京	jingTP
亰	jingTQ
坓	jingTS
坕	jingTT
坙	jingTU
茎	jingU
菁	jingUC
荆	jingUP
荊	jingUQ
莖	jingUS
葏	jingUT
儆	jingV
俓	jingVQ
倞	jingVS
傹	jingVT
敬	jingW
璄	jingWQ
璟	jingWS
璥	jingWT
惊	jingX
憬	jingXP
憼	jingXQ
穽	jingXS
警	jingY
鲸	jingYC
颈	jingYP
頸	jingYQ
鯽	jingYQR
鯨	jingYS
鯚	jingYSR
丼	jingYT
鮆	jingYTR
誩	jingYU
魥	jingYUR
鰶	jingYV
頚	jingYVR
魢	jingYW
鰿	jingYX
魝	jingYY
鱀	jingYZ
迳	jingZ
踁	jingZQ
逕	jingZS
烬	jinH
煡	jinHQ
燼	jinHS
黅	jinHT
槿	jinI
枃	jinIQ
榗	jinIS
金	jinJ
锦	jinJC
巾	jinJD
矜	jinJE
觐	jinJF
卺	jinJG
斤	jinJP
錦	jinJQ
覲	jinJS
觔	jinJT
釒	jinJU
釿	jinJV
钅	jinJW
筋	jinK
衿	jinKC
襟	jinKP
竻	jinKQ
笒	jinKS
劲	jinL
劤	jinLQ
勁	jinLS
鹶	jinLT
乁	jiNM
盡	jinMQ
矝	jinMS
馸	jinMT
鹡	jiNN
婜	jinNQ
妗	jinNR
嫤	jinNS
嬐	jinNT
嬧	jinNU
鶺	jiNO
噤	jinOP
唫	jinOQ
嚍	jinOS
嫉	jiNP
尽	jinPA
砛	jinPQ
鷄	jiNQ
歏	jinQQ
晋	jinR
晉	jinRQ
鸄	jiNS
禁	jinSA
馑	jinSP
祲	jinSQ
饉	jinSS
鷑	jiNT
埐	jinTQ
堻	jinTS
墐	jinTT
壗	jinTU
妀	jiNU
堇	jinUA
荩	jinUP
荕	jinUQ
菫	jinUS
菳	jinUT
蓳	jinUU
藎	jinUV
今	jinV
仅	jinVP
僅	jinVQ
仐	jinVS
伒	jinVT
侭	jinVU
僸	jinVV
儘	jinVW
姞	jiNW
瑾	jinWA
珒	jinWQ
琎	jinWS
琻	jinWT
瑨	jinWU
璡	jinWV
璶	jinWW
鳮	jiNX
惍	jinXQ
慬	jinXS
鵋	jiNY
谨	jinYA
謹	jinYQ
进	jinZ
近	jinZP
進	jinZQ
臸	jinZS
吉	jiO
唧	jiOC
咭	jiOD
哜	jiOE
臦	jiongCQ
臩	jiongCS
泂	jiongEQ
浻	jiongES
澃	jiongET
絅	jiongFQ
綗	jiongFS
炯	jiongH
扃	jiongHP
扄	jiongHQ
烱	jiongHS
煚	jiongHT
煛	jiongHU
熲	jiongHV
燛	jiongHW
銄	jiongJQ
褧	jiongKQ
駉	jiongMQ
駫	jiongMS
冋	jiongTQ
冏	jiongTS
坰	jiongTT
埛	jiongTU
冂	jiongTV
蘏	jiongUQ
蘔	jiongUS
侰	jiongVQ
僒	jiongVS
囧	jiongWQ
窘	jiongX
顈	jiongYQ
颎	jiongYS
迥	jiongZ
逈	jiongZQ
叽	jiOP
嘰	jiOQ
喞	jiOS
嗘	jiOT
嚌	jiOU
及	jiP
屐	jiPC
矶	jiPP
毄	jiPQ
磯	jiPS
磼	jiPT
硛	jiPU
犱	jiQQ
齊	jiQS
齌	jiQT
齎	jiQU
齏	jiQV
霁	jiR
暩	jiRQ
曁	jiRS
霵	jiRT
霽	jiRU
祭	jiS
羁	jiSC
岌	jiSD
嵴	jiSE
羇	jiSM
罽	jiSN
禨	jiSO
饥	jiSP
飢	jiSQ
饑	jiSS
躸	jiST
羈	jiSU
卙	jiSV
屰	jiSW
嵆	jiSX
嶯	jiSY
禝	jiSZ
基	jiT
圾	jiTC
墼	jiTD
畸	jiTP
坖	jiTQ
垍	jiTS
堲	jiTT
塉	jiTU
畟	jiTV
藉	jiU
揪	jiuA
捄	jiuAQ
揂	jiuAS
揫	jiuAT
摎	jiuAU
疚	jiuB
鬏	jiuBP
勼	jiuBQ
匓	jiuBS
镹	jiuBT
荠	jiUC
齨	jiuCQ
厩	jiuCR
蒺	jiUD
剹	jiuDQ
殧	jiuDS
鬮	jiuDT
芨	jiUE
氿	jiuEQ
汣	jiuES
蕺	jiUF
纠	jiuFA
韭	jiuFP
糾	jiuFQ
匛	jiuFS
匶	jiuFT
糺	jiuFU
紤	jiuFV
芰	jiUG
廄	jiuGQ
廏	jiuGS
廐	jiuGT
灸	jiuH
稵	jiuHQ
桕	jiuI
柩	jiuIP
朻	jiuIQ
杦	jiuIS
柾	jiuIT
樛	jiuIU
欍	jiuIV
舅	jiuJ
就	jiuJA
臼	jiuJP
舊	jiuJQ
韮	jiuJS
葪	jiUK
蓟	jiul
丩	jiuLQ
麔	jiuLS
薺	jiUM
阄	jiuMR
薊	jiUN
鹫	jiuNP
奺	jiuNQ
鸠	jiuNR
牞	jiuNS
鳩	jiuNT
鷲	jiuNU
蕀	jiUO
啾	jiuOP
咎	jiuOR
九	jiuP
久	jiuPP
乆	jiuPQ
虀	jiUQ
酒	jiuQA
旧	jiuR
蘻	jiUS
舏	jiuSQ
蘮	jiUT
就	jiuTA
蘎	jiUU
萛	jiuUQ
苙	jiUV
乣	jiuVQ
僦	jiuVR
倃	jiuVS
茍	jiUW
救	jiuWA
玖	jiuWP
茤	jiUX
究	jiuXA
慦	jiuXQ
就	jiuY
鯦	jiuYQ
蔇	jiUZ
蹵	jiuZQ
赳	jiuZR
伎	jiV
佶	jiVC
偈	jiVP
亼	jiVQ
亽	jiVS
伋	jiVT
偮	jiVU
僟	jiVV
玑	jiW
齑	jiWP
敧	jiWQ
璣	jiWS
璾	jiWT
急	jiX
悸	jiXC
懻	jiXO
忌	jiXP
覊	jiXQ
覉	jiXS
尐	jiXT
彑	jiXU
忣	jiXV
惎	jiXW
愱	jiXX
憿	jiXY
懠	jiXZ
计	jiY
鲫	jiYC
讥	jiYD
畿	jiYE
鲚	jiYF
諆	jiYL
諅	jiYM
誋	jiYN
詰	jiYO
记	jiYP
譏	jiYQ
幾	jiYS
計	jiYT
記	jiYU
鱭	jiYV
譤	jiYW
鱾	jiYX
諔	jiYY
叝	jiYZ
集	jiZ
迹	jiZC
亟	jiZD
跻	jiZE
乩	jiZF
跽	jiZG
﨤	jiZJ
踖	jiZK
踑	jiZL
趞	jiZM
趌	jiZN
艥	jiZO
季	jiZP
雞	jiZQ
跡	jiZS
雧	jiZT
躤	jiZU
躋	jiZV
蹟	jiZW
蹐	jiZX
攲	jiZY
臮	jiZZ
据	juA
拘	juAC
掬	juAD
捐	juanA
捲	juanAQ
奆	juanDQ
奍	juanDS
卷	juanE
涓	juanEP
巻	juanEQ
淃	juanES
绢	juanF
鄄	juanFP
絹	juanFQ
絭	juanFS
縳	juanFT
弮	juanGQ
鞙	juanGS
焆	juanHQ
桊	juanI
梋	juanIQ
棬	juanIS
椦	juanIT
镌	juanJ
锩	juanJP
帣	juanJQ
鋑	juanJS
鋗	juanJT
錈	juanJU
鎸	juanJV
鐫	juanJW
裐	juanKQ
劵	juanLQ
勌	juanLS
勬	juanLT
朘	juanLU
脧	juanLV
腃	juanLW
臇	juanLX
眷	juanM
睊	juanMQ
睠	juanMS
闂	juanMT
娟	juanN
鹃	juanNP
鵑	juanNQ
姢	juanNS
婘	juanNT
呟	juanOQ
狷	juanQ
獧	juanQQ
蠲	juanS
嶲	juanSQ
巂	juanSS
罥	juanST
羂	juanSU
飬	juanSV
餋	juanSW
埍	juanTQ
菤	juanUQ
蔨	juanUS
倦	juanV
圏	juanWQ
瓹	juanWS
悁	juanXQ
惓	juanXS
慻	juanXT
讂	juanYQ
隽	juanZ
踡	juanZQ
雋	juanZS
拒	juAP
據	juAQ
抅	juAS
拠	juAT
挙	juAU
挶	juAV
捄	juAW
揟	juAX
擧	juAY
具	juB
疽	juBP
匊	juBQ
寠	juBS
车	juC
龃	juCC
忂	juCQ
蚷	juCS
蜛	juCT
螶	juCU
車	juCV
輂	juCW
齟	juCX
举	juD
剧	juDP
劇	juDQ
沮	juE
掘	jueA
撅	jueAC
抉	jueAD
攫	jueAP
挗	jueAQ
捔	jueAS
撧	jueAT
决	jueB
疦	jueBQ
瘚	jueBS
厥	jueC
孓	jueCP
虳	jueCQ
蚗	jueCS
蟨	jueCT
蟩	jueCU
劂	jueD
刔	jueDQ
決	jueEQ
泬	jueES
灍	jueET
绝	jueF
絕	jueFQ
匷	jueFS
絶	jueFT
繘	jueFU
弡	jueGQ
彏	jueGS
髉	jueGT
爝	jueH
焳	jueHQ
熦	jueHS
燋	jueHT
爑	jueHU
穱	jueHV
橛	jueI
桷	jueIP
橜	jueIQ
櫭	jueIS
觉	jueJ
觖	jueJC
镢	jueJP
钁	jueJQ
覐	jueJS
覚	jueJT
覺	jueJU
觮	jueJV
觼	jueJW
鈌	jueJX
鐍	jueJY
鐝	jueJZ
袦	jueKQ
臄	jueLQ
矞	jueMQ
矡	jueMS
闕	jueMT
駃	jueMU
妜	jueNQ
鴂	jueNS
鴃	jueNT
鷢	jueNU
嚼	jueO
噱	jueOC
噘	jueOP
吷	jueOQ
噊	jueOS
屩	juePQ
屫	juePS
砄	juePT
泃	juEQ
獗	jueQA
欮	jueQQ
玃	jueQS
泦	juES
崛	jueSA
崫	jueSQ
嶡	jueSS
嶥	jueST
氒	jueSU
洰	juET
埆	jueTQ
壆	jueTS
涺	juEU
芵	jueUQ
蕨	jueUR
蕝	jueUS
淗	juEV
倔	jueVA
亅	jueVQ
傕	jueVS
湨	juEW
斍	jueWQ
珏	jueWR
玦	jueWS
玨	jueWT
瑴	jueWU
璚	jueWV
澽	juEX
憠	jueXQ
憰	jueXS
戄	jueXT
诀	jueY
矍	jueYC
谲	jueYP
訣	jueYQ
叕	jueYS
誳	jueYT
譎	jueYU
鱖	jueYV
爵	jueZ
蹶	jueZP
躩	jueZQ
孒	jueZS
爴	jueZT
貜	jueZU
赽	jueZV
趉	jueZW
趹	jueZX
蹷	jueZY
蹻	jueZZ
巨	juF
飓	juFC
聚	juFP
繘	juFQ
聥	juFS
邭	juFT
郹	juFU
陱	juFV
颶	juFW
巪	juFX
乬	juFY
鞠	juG
鞫	juGP
弆	juGQ
炬	juH
且	juhp
焗	juHQ
焣	juHS
秬	juHT
虡	juHU
橘	juI
榘	juIC
榉	juID
椐	juIE
枸	juIP
櫃	juIQ
梮	juIS
椇	juIT
椈	juIU
檋	juIV
櫸	juIW
欅	juIX
﨔	juIY
锯	juJ
锔	juJC
钜	juJP
舉	juJQ
鋸	juJS
凥	juJT
鉅	juJU
鋦	juJV
鐻	juJW
裾	juK
筥	juKQ
簴	juKS
籧	juKT
袓	juKU
襷	juKV
勮	juLQ
耟	juLS
腒	juLT
驹	juM
駏	juMO
駒	juMQ
驧	juMS
駶	juMT
毩	juMU
毱	juMV
眗	juMW
粔	juMX
粷	juMY
閰	juMZ
犋	juN
捃	junA
攈	junAQ
攟	junAS
寯	junBQ
賐	junBS
娵	juNC
軍	junCQ
蚐	junCS
蜠	junCT
浚	junE
汮	junEQ
濬	junES
郡	junF
陖	junFQ
婅	juNG
龜	junGQ
鵴	juNH
焌	junHQ
燇	junHS
桾	junIQ
棞	junIS
钧	junJ
鈞	junJQ
覠	junJS
銁	junJT
銞	junJU
鍕	junJV
筠	junK
箘	junKQ
箟	junKS
袀	junKT
竣	junL
麇	junLP
麏	junLQ
麕	junLS
军	junM
骏	junMP
駿	junMQ
鶋	juNN
姰	junNQ
鵔	junNS
鵕	junNT
鵘	junNU
君	junO
呁	junOQ
皸	junPQ
皹	junPS
碅	junPT
鶪	juNQ
姖	juNR
晙	junRQ
峻	junS
餕	junSQ
馂	junSS
均	junT
埈	junTQ
畯	junTS
菌	junU
莙	junUQ
葰	junUS
俊	junV
儁	junVQ
婮	juNW
珺	junWQ
犑	juNX
懏	junXQ
鴡	juNY
頵	junYQ
鮶	junYS
鲪	junYT
鵙	juNZ
雋	junZQ
皲	junZR
句	juO
咀	juOP
啹	juOQ
局	juP
屦	juPC
居	juPP
屨	juPQ
砠	juPS
狙	juQ
醵	juQP
狊	juQQ
豦	juQS
昛	juRQ
矩	juSP
岠	juSQ
岨	juSS
崌	juST
巈	juSU
罝	juSV
躹	juSW
鼰	juSX
鼳	juSY
埧	juTQ
埾	juTS
壉	juTT
菊	juU
莒	juUC
苴	juUD
苣	juUP
蒟	juUQ
蒩	juUS
蓻	juUT
蘜	juUU
俱	juV
倨	juVP
伡	juVQ
侷	juVS
俥	juVT
倶	juVU
僪	juVV
琚	juW
珇	juWQ
惧	juX
窭	juXP
懼	juXQ
怇	juXS
怐	juXT
怚	juXU
愳	juXV
懅	juXW
窶	juXX
讵	juY
詎	juYQ
諊	juYS
鮈	juYT
鮔	juYU
距	juZ
踽	juZC
遽	juZD
趄	juZE
雎	juZF
踘	juZO
踞	juZP
躆	juZQ
蹫	juZS
歫	juZT
艍	juZU
貗	juZV
趜	juZW
跔	juZX
跙	juZY
跼	juZZ
侷	jvVQ
揩	kaiA
輆	kaiCQ
剀	kaiD
剴	kaiDQ
奒	kaiDS
豈	kaiDT
濭	kaiEQ
颽	kaiFQ
开	kaiG
炌	kaiHQ
烗	kaiHS
楷	kaiI
凯	kaiJ
锴	kaiJC
锎	kaiJD
铠	kaiJP
凱	kaiJQ
鍇	kaiJS
鎎	kaiJT
鎧	kaiJU
鐦	kaiJV
勓	kaiLQ
開	kaiMQ
闓	kaiMS
闿	kaiMT
嘅	kaiOQ
桛	kaIQ
欬	kaiQQ
欯	kaiQS
暟	kaiRQ
嵦	kaiSQ
垲	kaiT
塏	kaiTQ
蒈	kaiU
慨	kaiX
忾	kaiXC
恺	kaiXP
愒	kaiXQ
愷	kaiXS
愾	kaiXT
鉲	kaJQ
裃	kaKQ
卡	kaL
胩	kaLP
扻	kanAQ
輡	kanCQ
轗	kanCS
刊	kanD
鬫	kanDQ
戡	kanG
抗	kangA
扛	kangAP
摃	kangAQ
漮	kangEQ
匟	kangFQ
邟	kangFS
康	kangG
炕	kangH
穅	kangHQ
槺	kangIQ
钪	kangJ
鈧	kangJQ
鏮	kangJS
糠	kangM
闶	kangMP
粇	kangMQ
閌	kangMS
嫝	kangNQ
砊	kangPQ
犺	kangQQ
嵻	kangSQ
躿	kangSS
亢	kangT
伉	kangV
囥	kangWQ
慷	kangX
忼	kangXQ
鱇	kangYQ
槛	kanI
檻	kanIQ
栞	kanIS
凵	kanKQ
勘	kanL
龛	kanLP
竷	kanLQ
龕	kanLS
看	kanM
阚	kanMC
瞰	kanMP
冚	kanMQ
矙	kanMS
闞	kanMT
砍	kanP
磡	kanPQ
欿	kanQQ
歁	kanQS
崁	kanSQ
嵁	kanSS
堪	kanT
坎	kanTP
埳	kanTQ
墈	kanTS
莰	kanU
侃	kanV
偘	kanVQ
惂	kanXQ
衎	kanXS
顑	kanYQ
咯	kaO
拷	kaoA
咖	kaOC
咔	kaOD
洘	kaoEQ
靠	kaoF
髛	kaoGQ
烤	kaoH
丂	kaoHQ
焅	kaoHS
熇	kaoHT
栲	kaoI
铐	kaoJ
銬	kaoJQ
考	kaoL
犒	kaoN
喀	kaOP
尻	kaoPR
嵪	kaoSQ
薧	kaoUQ
攷	kaoWQ
鮳	kaoYQ
鯌	kaoYS
鲓	kaoYT
垰	kaTQ
佧	kaV
揢	keAQ
搕	keAS
客	keB
疴	keBP
痾	keBQ
蝌	keC
轲	keCP
尅	keCQ
軻	keCS
刻	keD
剋	keDQ
渴	keE
溘	keEP
渇	keEQ
濭	keES
缂	keF
匼	keFQ
緙	keFS
髁	keG
科	keH
稞	keHP
炣	keHQ
棵	keI
尅	keiCQ
剋	keiDQ
柯	keIP
榼	keIQ
樖	keIS
钶	keJ
锞	keJP
鈳	keJQ
鉿	keJS
錁	keJT
袔	keKQ
勀	keLQ
勊	keLS
瞌	keM
骒	keMP
閜	keMQ
騍	keMS
騾	keMT
掯	kenAQ
龈	kenC
齗	kenCQ
齦	kenCS
龂	kenCT
挳	kengAQ
揁	kengAS
摼	kengAT
阬	kengFQ
铿	kengJ
銵	kengJQ
鍞	kengJS
鏗	kengJT
劥	kengLQ
妔	kengNQ
牼	kengNS
吭	kengO
殸	kengPQ
硁	kengPS
硜	kengPT
硻	kengPU
坑	kengT
坈	kengTQ
誙	kengYQ
錹	kenJQ
裉	kenK
褃	kenKQ
肯	kenL
肎	kenLQ
肻	kenLS
啃	kenO
硍	kenPQ
娔	keNQ
豤	kenQQ
牱	keNS
垦	kenT
墾	kenTQ
犐	keNU
珢	kenWQ
恳	kenX
懇	kenXQ
貇	kenZQ
可	keO
嗑	keOC
咳	keOP
磕	keP
礚	kePQ
殻	kePS
殼	kePT
牁	kePU
砢	kePV
硞	kePW
碦	kePX
磆	kePY
礊	kePZ
氪	keQ
欬	keQQ
歁	keQS
醘	keQT
克	keS
岢	keSC
壳	keSP
峇	keSQ
嵑	keSS
嵙	keST
嶱	keSU
坷	keT
堁	keTQ
苛	keU
萪	keUQ
薖	keUS
珂	keW
敤	keWQ
窠	keX
恪	keXP
悈	keXQ
愘	keXS
愙	keXT
窼	keXU
衉	keXV
课	keY
颏	keYC
颗	keYP
課	keYQ
顆	keYS
翗	keYT
頦	keYU
艐	keZQ
趷	keZS
控	kongA
涳	kongEQ
鞚	kongGQ
椌	kongIQ
錓	kongJQ
箜	kongK
鵼	kongNQ
矼	kongPQ
硿	kongPS
崆	kongS
躻	kongSQ
埪	kongTQ
倥	kongV
空	kongX
恐	kongXP
悾	kongXQ
羫	kongYQ
孔	kongZ
扣	kouA
抠	kouAP
摳	kouAQ
寇	kouB
宼	kouBQ
剾	kouDQ
滱	kouEQ
彄	kouGQ
釦	kouJQ
筘	kouK
簆	kouKQ
劶	kouLQ
竘	kouLS
眍	kouM
冦	kouMQ
眗	kouMS
瞉	kouMT
瞘	kouMU
鷇	kouNQ
口	kouO
叩	kouOP
蔻	kouU
芤	kouUP
蔲	kouUQ
囗	kouW
敂	kouWQ
怐	kouXQ
窛	kouXS
挎	kuaA
夸	kuaD
絓	kuaFQ
骻	kuaGQ
擓	kuaiAQ
巜	kuaiCQ
蒯	kuaiD
浍	kuaiE
澮	kuaiEQ
郐	kuaiF
旝	kuaiFQ
鄶	kuaiFS
廥	kuaiGQ
筷	kuaiK
凷	kuaiKQ
脍	kuaiL
膾	kuaiLQ
糩	kuaiMQ
駃	kuaiMS
哙	kuaiO
噲	kuaiOQ
狯	kuaiQ
欳	kuaiQQ
楇	kuaIQR
獪	kuaiQS
會	kuaiRQ
块	kuaiT
塊	kuaiTQ
圦	kuaiTS
墤	kuaiTT
蕢	kuaiUQ
会	kuaiV
侩	kuaiVP
儈	kuaiVQ
璯	kuaiWQ
快	kuaiX
鱠	kuaiYQ
鲙	kuaiYS
銙	kuaJQ
胯	kuaL
宽	kuanB
寬	kuanBQ
寛	kuanBS
髋	kuanG
抂	kuangAQ
况	kuangB
贶	kuangBP
卝	kuangBQ
貺	kuangBS
軖	kuangCQ
軠	kuangCS
軦	kuangCT
軭	kuangCU
夼	kuangD
況	kuangEQ
洭	kuangES
匡	kuangF
纩	kuangFC
邝	kuangFP
匩	kuangFQ
絋	kuangFS
絖	kuangFT
纊	kuangFU
邼	kuangFV
鄺	kuangFW
爌	kuangHQ
穬	kuangHS
黋	kuangHT
框	kuangI
鉱	kuangJQ
鋛	kuangJS
鑛	kuangJT
筐	kuangK
筺	kuangKQ
丱	kuangLQ
劻	kuangLS
眶	kuangM
眖	kuangMQ
矌	kuangMS
鵟	kuangNQ
哐	kuangO
矿	kuangP
礦	kuangPQ
砿	kuangPS
硄	kuangPT
狂	kuangQ
狅	kuangQQ
髖	kuanGQR
旷	kuangR
曠	kuangRQ
昿	kuangRS
岲	kuangSQ
圹	kuangT
壙	kuangTQ
儣	kuangVQ
忹	kuangXQ
恇	kuangXS
懬	kuangXT
懭	kuangXU
诳	kuangY
诓	kuangYP
誆	kuangYQ
誑	kuangYS
迋	kuangZQ
梡	kuanIQ
鑧	kuanJQ
臗	kuanLQ
款	kuanQ
欵	kuanQQ
姱	kuaNQR
歀	kuanQS
窽	kuanXQ
窾	kuanXS
咵	kuaOQ
扝	kuAQ
晇	kuaRQ
捁	kuAS
垮	kuaT
搰	kuAU
侉	kuaV
恗	kuaXQ
誇	kuaYQ
跨	kuaZ
舿	kuaZQ
趶	kuaZS
瘔	kuBQ
刳	kuD
绔	kuF
絝	kuFQ
郀	kuFS
库	kuG
骷	kuGP
庫	kuGQ
廤	kuGS
焅	kuHQ
秙	kuHS
枯	kuI
揆	kuiA
夔	kuiB
蝰	kuiC
奎	kuiD
刲	kuiDQ
殨	kuiDS
溃	kuiE
潰	kuiEQ
匮	kuiF
隗	kuiFC
聩	kuiFP
匱	kuiFQ
聧	kuiFS
聭	kuiFT
聵	kuiFU
鄈	kuiFV
魁	kuiG
戣	kuiGQ
亏	kuiH
虧	kuiHQ
煃	kuiHS
楏	kuiIQ
楑	kuiIS
櫆	kuiIT
鍨	kuiJQ
鍷	kuiJS
篑	kuiK
簣	kuiKQ
籄	kuiKS
胿	kuiLQ
膭	kuiLS
盔	kuiM
睽	kuiMP
瞆	kuiMQ
瞶	kuiMS
闚	kuiMT
騤	kuiMU
骙	kuiMV
媿	kuiNQ
嬇	kuiNS
犪	kuiNT
喟	kuiO
喹	kuiOP
嘳	kuiOQ
馗	kuiP
磈	kuiPQ
桍	kuIQ
暌	kuiR
晆	kuiRQ
馈	kuiS
岿	kuiSP
饋	kuiSQ
巋	kuiSS
巙	kuiST
餽	kuiSU
楛	kuIT
葵	kuiU
蒉	kuiUP
蕢	kuiUQ
藈	kuiUS
蘷	kuiUT
虁	kuiUU
傀	kuiV
愧	kuiX
悝	kuiXC
愦	kuiXD
窥	kuiXP
窺	kuiXQ
憒	kuiXS
尯	kuiYQ
謉	kuiYS
頍	kuiYT
頯	kuiYU
顝	kuiYV
鮭	kuiYW
逵	kuiZ
跬	kuiZP
歸	kuiZQ
蹞	kuiZS
躨	kuiZT
裤	kuK
褲	kuKQ
袴	kuKS
朏	kuLQ
胐	kuLS
捆	kunA
髡	kunB
髠	kunBQ
髨	kunBS
蜫	kunCQ
涃	kunEQ
潉	kunES
綑	kunFQ
焜	kunHQ
熴	kunHS
稇	kunHT
稛	kunHU
梱	kunIQ
锟	kunJ
錕	kunJQ
裈	kunKQ
裍	kunKS
裩	kunKT
褌	kunKU
阃	kunM
睏	kunMQ
閫	kunMS
閸	kunMT
騉	kunMU
婫	kunNQ
鵾	kunNS
鶤	kunNT
鹍	kunNU
硱	kunPQ
醌	kunQ
猑	kunQQ
昆	kunR
晜	kunRQ
壸	kunSQ
壼	kunSS
崐	kunST
崑	kunSU
祵	kunSV
坤	kunT
堃	kunTQ
堒	kunTS
菎	kunUQ
困	kunW
琨	kunWP
瑻	kunWQ
悃	kunX
鲲	kunY
鯤	kunYQ
貇	kunZQ
哭	kuO
括	kuoA
扩	kuoAP
擴	kuoAQ
拡	kuoAS
挄	kuoAT
髺	kuoBQ
鬠	kuoBS
蛞	kuoC
漷	kuoEQ
濶	kuoES
廓	kuoG
鞟	kuoGQ
鞹	kuoGS
秮	kuoHQ
秳	kuoHS
銛	kuoJQ
銽	kuoJS
铦	kuoJT
筈	kuoKQ
阔	kuoM
闊	kuoMQ
噋	kuoOQ
喾	kuOP
嚳	kuOQ
霩	kuoRQ
萿	kuoUQ
葀	kuoUS
韕	kuoWQ
頢	kuoYQ
矻	kuPQ
硞	kuPS
酷	kuQ
狜	kuQQ
堀	kuT
苦	kuU
俈	kuVQ
圐	kuWQ
窟	kuX
窋	kuXQ
鮬	kuYQ
跍	kuZQ
拉	laA
揦	laAQ
揧	laAS
搚	laAT
擸	laAU
攋	laAV
瘌	laB
癩	laBQ
鬎	laBS
蜡	laC
蝋	laCQ
蝲	laCS
蠟	laCT
剌	laD
溂	laEQ
鞡	laGQ
爉	laHQ
攋	laiAQ
赖	laiB
赉	laiBC
癞	laiBP
賴	laiBQ
癘	laiBS
癩	laiBT
賚	laiBU
賫	laiBV
徕	laiC
徠	laiCQ
涞	laiE
濑	laiEP
淶	laiEQ
瀨	laiES
瀬	laiET
郲	laiFQ
庲	laiGQ
来	laiI
梾	laiIQ
棶	laiIS
櫴	laiIT
铼	laiJ
錸	laiJQ
籁	laiK
筙	laiKQ
箂	laiKS
籟	laiKT
襰	laiKU
勑	laiLQ
睐	laiM
睞	laiMQ
騋	laiMS
麳	laiMT
娕	laiNQ
婡	laiNS
鵣	laiNT
鶆	laiNU
唻	laiOQ
柆	laIQ
猍	laiQQ
楋	laIS
崍	laiSQ
崃	laiSR
櫴	laIT
莱	laiU
萊	laiUQ
藾	laiUS
來	laiVQ
俫	laiVS
倈	laiVT
琜	laiWQ
誺	laiYQ
頼	laiYS
顂	laiYT
鯠	laiYU
逨	laiZQ
鑞	laJQ
镴	laJS
腊	laL
臈	laLQ
臘	laLS
拦	lanA
揽	lanAP
攔	lanAQ
攬	lanAS
擥	lanAT
兰	lanB
厱	lanCQ
滥	lanE
漤	lanEC
澜	lanEP
濫	lanEQ
瀾	lanES
浨	lanET
灆	lanEU
灠	lanEV
灡	lanEW
缆	lanF
纜	lanFQ
繿	lanFS
螂	langC
蜋	langCQ
浪	langE
郎	langF
郒	langFQ
郞	langFS
廊	langG
稂	langH
烺	langHQ
榔	langI
桹	langIQ
樃	langIS
鋃	langJQ
鎯	langJS
筤	langKQ
朗	langL
勆	langLQ
朖	langLS
朤	langLT
阆	langM
閬	langMQ
駺	langMS
嫏	langNQ
啷	langO
哴	langOQ
硠	langPQ
狼	langQ
欴	langQQ
韊	lanGQR
崀	langSQ
躴	langSS
埌	langTQ
塱	langTS
蒗	langU
蓈	langUQ
蓢	langUS
琅	langW
斏	langWQ
瑯	langWS
誏	langYQ
艆	langZQ
烂	lanH
爛	lanHQ
燗	lanHS
燣	lanHT
燷	lanHU
爁	lanHV
爤	lanHW
爦	lanHX
栏	lanI
榄	lanIP
欄	lanIQ
欖	lanIS
欗	lanIT
览	lanJ
镧	lanJP
覽	lanJQ
幱	lanJS
覧	lanJT
鑭	lanJU
钄	lanJV
篮	lanK
褴	lanKP
籃	lanKQ
籣	lanKS
襕	lanKT
襤	lanKU
襴	lanKV
襽	lanKW
阑	lanM
糷	lanMQ
闌	lanMS
婪	lanN
嬾	lanNQ
孄	lanNS
孏	lanNT
嚂	lanOQ
囒	lanOS
囕	lanOT
醂	lanQQ
暕	lanRQ
岚	lanS
罱	lanSP
嵐	lanSQ
坔	lanTQ
壈	lanTS
壏	lanTT
蓝	lanU
藍	lanUQ
蘭	lanUS
葻	lanUT
蘫	lanUU
儖	lanVQ
斓	lanW
斕	lanWQ
璼	lanWS
瓓	lanWT
懒	lanX
懶	lanXQ
惏	lanXS
懢	lanXT
谰	lanY
譋	lanYQ
讕	lanYS
顲	lanYT
躝	lanZQ
啦	laO
捞	laoA
撈	laoAQ
痨	laoB
癆	laoBQ
蟧	laoCQ
轑	laoCS
蛯	laoCT
涝	laoE
潦	laoEP
澇	laoEQ
浶	laoES
絡	laoFQ
髝	laoGQ
烙	laoH
栳	laoI
橯	laoIQ
铹	laoJ
铑	laoJP
銠	laoJQ
鐒	laoJS
簩	laoKQ
老	laoL
耢	laoLC
劳	laoLP
勞	laoLQ
労	laoLS
朥	laoLT
耂	laoLU
耮	laoLV
粩	laoMQ
閖	laoMS
牢	laoN
姥	laoNP
嫪	laoNQ
唠	laoO
嘮	laoOQ
咾	laoOS
哰	laoOT
嗠	laoOU
喇	laOP
硓	laoPQ
磱	laoPS
酪	laoQ
醪	laoQP
狫	laoQQ
崂	laoS
嶗	laoSQ
躼	laoSS
軂	laoST
嚹	laOT
荖	laoUQ
佬	laoV
僗	laoVQ
珯	laoWQ
忉	laoX
恅	laoXQ
憥	laoXS
憦	laoXT
窂	laoXU
顟	laoYQ
鮱	laoYS
鱩	laoYT
砬	laP
磖	laPQ
旯	laR
垃	laT
落	laU
菈	laUQ
藞	laUS
瓎	laWQ
辣	laX
辢	laXQ
翋	laYQ
鯻	laYS
邋	laZ
扐	leAQ
忇	leCQ
泐	leE
氻	leEQ
阞	leFQ
擂	leiA
攂	leiAQ
瘣	leiBQ
癗	leiBS
蠝	leiCQ
轠	leiCS
泪	leiE
淚	leiEQ
洡	leiES
涙	leiET
灅	leiEU
累	leiF
缧	leiFP
絫	leiFQ
縲	leiFS
纇	leiFT
纍	leiFU
纝	leiFV
罍	leiFW
檑	leiI
樏	leiIQ
櫐	leiIS
櫑	leiIT
欙	leiIU
镭	leiJ
銇	leiJQ
錑	leiJS
鐳	leiJT
鑘	leiJU
鑸	leiJV
肋	leiL
耒	leiLP
类	leiM
矋	leiMQ
嫘	leiN
鸓	leiNQ
嘞	leiO
磊	leiP
磥	leiPQ
礌	leiPS
礧	leiPT
礨	leiPU
樂	leIQ
酹	leiQR
雷	leiR
靁	leiRQ
楽	leIS
厽	leiSQ
祱	leiSS
禷	leiST
鼺	leiSU
垒	leiT
羸	leiTP
壘	leiTQ
塁	leiTS
壨	leiTT
畾	leiTU
蕾	leiU
蔂	leiUQ
蕌	leiUS
藟	leiUT
蘱	leiUU
蘲	leiUV
蘽	leiUW
虆	leiUX
儡	leiV
傫	leiVQ
儽	leiVS
瓃	leiWQ
诔	leiY
類	leiYQ
誄	leiYS
讄	leiYT
頛	leiYU
頪	leiYV
颣	leiYW
竻	leKQ
簕	leKS
勒	leL
冷	lengB
漓	lengE
稜	lengHQ
楞	lengI
棱	lengIP
睖	lengMQ
唥	lengOQ
吏	lengP
碐	lengPQ
塄	lengT
堎	lengTQ
荔	lengU
薐	lengUQ
俐	lengV
倰	lengVQ
愣	lengX
踜	lengZQ
牞	leNQ
叻	leO
乐	leP
砳	lePQ
餎	leSQ
饹	leSS
艻	leUQ
了	leV
仂	leVP
玏	leWQ
鳓	leY
韷	leYQ
鰳	leYS
鱳	leYT
摙	lianAQ
鬑	lianBQ
蠊	lianC
螊	lianCQ
殓	lianD
奁	lianDP
劆	lianDQ
奩	lianDS
殮	lianDT
涟	lianE
潋	lianEC
濂	lianEP
湅	lianEQ
溓	lianES
漣	lianET
澰	lianEU
濓	lianEV
瀮	lianEW
瀲	lianEX
联	lianF
聮	lianFO
练	lianFP
聯	lianFQ
練	lianFS
鄻	lianFT
匲	lianFU
匳	lianFV
縺	lianFW
纞	lianFX
聨	lianFY
聫	lianFZ
廉	lianG
掚	liangAQ
凉	liangB
辆	liangC
輛	liangCQ
蜽	liangCS
輌	liangCT
輬	liangCU
辌	liangCV
涼	liangEQ
湸	liangES
緉	liangFQ
良	liangG
魉	liangGP
魎	liangGQ
两	liangH
両	liangHQ
梁	liangI
椋	liangIP
樑	liangIQ
锒	liangJ
鍄	liangJQ
裲	liangKQ
量	liangL
脼	liangLQ
粮	liangM
粱	liangMP
糧	liangMQ
駺	liangMS
哴	liangOQ
唡	liangOS
啢	liangOT
喨	liangOU
靓	liangQ
靚	liangQQ
晾	liangR
兩	liangRQ
亮	liangT
墚	liangTP
莨	liangU
俩	liangV
俍	liangVQ
倆	liangVS
倞	liangVT
悢	liangXQ
谅	liangY
諒	liangYQ
踉	liangZ
炼	lianH
煉	lianHQ
熑	lianHS
燫	lianHT
稴	lianHU
楝	lianI
梿	lianIQ
槏	lianIS
槤	lianIT
檶	lianIU
櫣	lianIV
链	lianJ
镰	lianJC
帘	lianJP
鏈	lianJQ
鐮	lianJS
覝	lianJT
錬	lianJU
鍊	lianJV
鎌	lianJW
裢	lianK
裣	lianKP
簾	lianKQ
籢	lianKS
籨	lianKT
褳	lianKU
襝	lianKV
脸	lianL
臁	lianLP
臉	lianLQ
媡	lianNQ
嫾	lianNS
嬚	lianNT
孌	lianNU
嗹	lianOQ
噒	lianOS
磏	lianPQ
歛	lianQQ
醶	lianQS
亷	lianTQ
堜	lianTS
莲	lianU
蔹	lianUP
蓮	lianUQ
萰	lianUS
薕	lianUT
薟	lianUU
蘝	lianUV
蘞	lianUW
僆	lianVQ
敛	lianW
琏	lianWP
斂	lianWQ
瑓	lianWS
璉	lianWT
恋	lianX
怜	lianXP
憐	lianXQ
戀	lianXS
慩	lianXT
鲢	lianY
羷	lianYQ
翴	lianYS
謰	lianYT
鰊	lianYU
鰱	lianYV
连	lianZ
連	lianZQ
蹥	lianZS
撩	liaoA
撂	liaoAP
摎	liaoAQ
疗	liaoB
寮	liaoBC
寥	liaoBP
療	liaoBQ
賿	liaoBS
镽	liaoBT
蟟	liaoCQ
蟧	liaoCS
料	liaoD
潦	liaoE
漻	liaoEQ
聊	liaoF
缭	liaoFP
繚	liaoFQ
繆	liaoFS
鄝	liaoFT
飂	liaoFU
飉	liaoFV
廖	liaoG
廫	liaoGQ
豂	liaoGS
髎	liaoGT
燎	liaoH
炓	liaoHQ
爎	liaoHS
爒	liaoHT
樛	liaoIQ
橑	liaoIS
镣	liaoJ
钌	liaoJP
釕	liaoJQ
鐐	liaoJS
簝	liaoKQ
膋	liaoLQ
膫	liaoLS
瞭	liaoMQ
鹩	liaoN
嫽	liaoNQ
鷯	liaoNS
嘹	liaoO
屪	liaoPQ
獠	liaoQ
暸	liaoRQ
嵺	liaoSQ
嶚	liaoSS
嶛	liaoST
蓼	liaoU
藔	liaoUQ
了	liaoV
僚	liaoVP
敹	liaoWQ
璙	liaoWS
尞	liaoXQ
憀	liaoXS
憭	liaoXT
窌	liaoXU
窷	liaoXV
竂	liaoXW
尥	liaoY
尦	liaoYQ
辽	liaoZ
遼	liaoZQ
蹘	liaoZS
蹽	liaoZT
扐	liAQ
扚	liAS
搮	liAT
擽	liAU
攊	liAV
攦	liAW
攭	liAX
痢	liB
疬	liBC
疠	liBP
凓	liBQ
癘	liBS
癧	liBT
皪	liBU
鬁	liBV
历	liC
厘	liCC
蛎	liCD
蠡	liCE
蜊	liCF
轹	liCG
蟍	liCK
蝷	liCL
蜧	liCM
蛠	liCN
蚸	liCO
厉	liCP
厲	liCQ
轣	liCS
轢	liCT
蠫	liCU
蠣	liCV
蠇	liCW
蟸	liCX
厤	liCY
厯	liCZ
利	liD
刕	liDQ
剓	liDS
剺	liDT
劙	liDU
豊	liDV
沥	liE
捩	lieA
挒	lieAQ
擸	lieAS
挘	lieAT
冽	lieB
鬣	lieBP
鬛	lieBQ
溧	liEC
巤	lieCQ
蛚	lieCS
列	lieD
洌	lieE
浖	lieEQ
澧	liEF
綟	lieFQ
聗	lieFS
颲	lieFT
烈	lieH
烮	lieHQ
煭	lieHS
燤	lieHT
爄	lieHU
爉	lieHV
栵	lieIQ
棙	lieIS
裂	lieK
劣	lieL
劦	lieLQ
劽	lieLS
脟	lieLT
瀝	liEN
姴	lieNQ
犣	lieNS
鴷	lieNT
咧	lieO
哷	lieOQ
漓	liEP
猎	lieQ
獵	lieQQ
猟	lieQS
獦	lieQT
沴	liES
巁	lieSQ
沵	liET
埓	lieTQ
埒	lieTR
浬	liEU
茢	lieUQ
浰	liEV
儠	lieVQ
涖	liEW
濿	liEX
忚	lieXQ
灕	liEY
鮤	lieYQ
鱲	lieYS
趔	lieZ
躐	lieZP
迾	lieZQ
缡	liF
郦	liFP
綟	liFQ
縭	liFS
纅	liFT
纚	liFU
酈	liFV
廲	liGQ
瓥	liGS
丽	liH
黧	liHC
戾	liHP
爄	liHQ
爏	liHS
秝	liHT
穲	liHU
李	liI
栗	liIC
栎	liID
枥	liIE
棙	liIJ
棃	liIK
梸	liIL
栛	liIM
栃	liIN
柂	liIO
梨	liIP
欚	liIQ
欐	liIS
櫪	liIT
櫟	liIU
櫔	liIV
檪	liIW
樆	liIX
朸	liIY
杝	liIZ
锂	liJ
鑗	liJQ
觻	liJS
鉝	liJT
銐	liJU
鋫	liJV
鋰	liJW
錅	liJX
鎘	liJY
鏫	liJZ
篱	liK
篥	liKC
笠	liKP
裏	LIKQ
裡	liKS
籬	LIKT
筣	LIKU
褵	liKV
里	liL
立	liLC
隶	liLD
励	liLE
膦	liLF
力	liLP
勵	liLQ
隸	liLS
麗	liLT
竰	liLU
脷	liLV
釐	liLW
隷	liLX
麜	liLY
粒	liM
粝	liMC
骊	liMP
盠	liMQ
盭	liMS
睙	liMT
睝	liMU
粴	liMV
糎	liMW
糲	liMX
驪	liMY
犁	liN
拎	linA
撛	linAQ
凛	linB
赁	linBP
凜	linBQ
賃	linBS
痳	linBT
癛	linBU
癝	linBV
娌	liNC
臨	linCQ
辚	linCR
轔	linCS
轥	linCT
嫠	liND
淋	linE
潾	linEQ
澟	linES
瀶	linET
邻	linF
鄰	linFQ
綝	linFS
繗	linFT
阾	linFU
隣	linFV
隣	linFW
廪	linG
掕	lingAQ
凌	lingB
皊	lingBQ
龄	lingC
蛉	lingCP
齡	lingCQ
彾	lingCS
軨	lingCT
輘	lingCU
齢	lingCV
刢	lingDQ
泠	lingE
淩	lingEQ
澪	lingES
陵	lingF
绫	lingFC
酃	lingFD
聆	lingFP
紷	lingFQ
綾	lingFS
灵	lingH
炩	lingHQ
燯	lingHS
爧	lingHT
秢	lingHU
稜	lingHV
棂	lingI
柃	lingIP
櫺	lingIQ
欞	lingIS
铃	lingJ
鈴	lingJQ
錂	lingJS
笭	lingKQ
袊	lingKS
裬	lingKT
朎	lingLQ
竛	lingLS
鹷	lingLT
麢	lingLU
龗	lingLV
閝	lingMQ
駖	lingMS
姈	lingNQ
婈	lingNS
孁	lingNT
鴒	lingNU
鸰	lingNV
另	lingO
呤	lingOP
砱	lingPQ
狑	lingQQ
廩	linGQR
醽	lingQS
零	lingR
靈	lingRQ
昤	lingRS
霊	lingRT
霗	lingRU
霛	lingRV
霝	lingRW
岭	lingS
嶺	lingSQ
岺	lingSS
崚	lingST
祾	lingSU
坽	lingTQ
菱	lingU
苓	lingUP
蓤	lingUQ
蔆	lingUS
蕶	lingUT
蘦	lingUU
令	lingV
伶	lingVP
玲	lingW
瓴	lingWC
囹	lingWP
琌	lingWQ
衑	lingXQ
领	lingY
羚	lingYC
鲮	lingYD
翎	lingYP
領	lingYQ
羐	lingYS
詅	lingYT
魿	lingYU
鯪	lingYV
〇	lingZ
夌	lingZQ
舲	lingZS
跉	lingZT
焛	linHQ
燐	linHS
林	linI
檩	linIP
橉	linIQ
檁	linIS
斴	linJQ
鏻	linJS
鳨	liNK
箖	linKQ
临	linL
麟	linLP
麐	linLQ
粼	linM
瞵	linMP
冧	linMQ
粦	linMS
閵	linMT
驎	linMU
鴗	liNN
吝	linO
啉	linOP
鹂	liNP
碄	linPQ
磷	linPR
鸝	liNQ
獜	linQQ
霖	linR
晽	linRQ
暽	linRS
鷅	liNS
厸	linSQ
嶙	linSR
崊	linSS
鵹	liNT
壣	linTQ
疄	linTS
娳	liNU
菻	linUQ
蔺	linUR
藺	linUS
婯	liNV
亃	linVQ
僯	linVS
孋	liNW
琳	linWA
璘	linWQ
甐	linWS
犂	liNX
恡	linXQ
懔	linXR
悋	linXS
惏	linXT
懍	linXU
犛	liNY
鳞	linYA
鱗	linYQ
翷	linYS
犡	liNZ
遴	linZP
躪	linZQ
躏	linZR
蹸	linZS
躙	linZT
哩	liO
唳	liOC
喱	liOD
呖	liOE
吏	liOP
唎	liOQ
嚟	liOS
嚦	liOT
囄	liOU
囇	liOV
砾	liP
砺	liPP
礫	liPQ
砅	liPS
磿	liPT
礪	liPU
礰	liPV
狸	liQ
醴	liQC
猁	liQP
醨	liQQ
雳	liR
靂	liRQ
暦	liRS
曆	liRT
曞	liRU
靋	liRV
礼	liS
罹	liSC
詈	liSD
黎	liSP
禮	liSQ
屴	liSS
岦	liST
峛	liSU
峢	liSV
峲	liSW
巁	liSX
禲	liSY
离	liT
坜	liTP
塛	liTQ
壢	liTS
莉	liU
摎	liuAQ
瘤	liuB
癅	liuBQ
藜	liUC
蟉	liuCQ
刘	liuD
劉	liuDQ
流	liuE
浏	liuEC
溜	liuEP
瀏	liuEQ
漻	liuES
澑	liuET
蓠	liUF
旒	liuFP
斿	liuFQ
绺	liuFR
旈	liuFS
綹	liuFT
陸	liuFU
飀	liuFV
飂	liuFW
飅	liuFX
飗	liuFY
莅	liUG
廇	liuGQ
鬸	liuGS
熘	liuH
熮	liuHQ
柳	liuI
榴	liuIP
栁	liuIQ
桞	liuIS
桺	liuIT
橊	liuIU
橮	liuIV
镏	liuJ
锍	liuJC
鎏	liuJP
鋶	liuJQ
鎦	liuJS
鏐	liuJT
鐂	liuJU
镠	liuJV
苈	liUK
裗	liuKQ
麍	liuLQ
骝	liuM
駠	liuMQ
駵	liuMS
騮	liuMT
驑	liuMU
鹨	liuN
媹	liuNQ
嬼	liuNS
鶹	liuNT
鷚	liuNU
鹠	liuNV
茘	liUO
嚠	liuOQ
荔	liUP
硫	liuPA
磂	liuPQ
磟	liuPS
蘺	liUQ
霤	liuRQ
苙	liUS
餾	liuSQ
馏	liuSR
嵧	liuSS
罶	liuST
羀	liuSU
六	liuT
留	liuTP
塯	liuTQ
畄	liuTS
畱	liuTT
疁	liuTU
荲	liUU
蒥	liuUQ
蓅	liuUS
藰	liuUT
菞	liUV
蒚	liUW
珋	liuWQ
琉	liuWR
瑠	liuWS
瑬	liuWT
璢	liuWU
蒞	liUX
懰	liuXQ
窌	liuXS
蔾	liUY
翏	liuYQ
鰡	liuYS
藶	liUZ
蹓	liuZQ
遛	liuZR
雡	liuZS
例	liV
俚	liVC
俪	liVD
傈	liVE
俐	liVP
儮	liVQ
儷	liVS
理	liW
璃	liWP
瓼	liWQ
斄	liWS
珕	liWT
琍	liWU
瑮	liWV
瓅	liWW
瓈	liWX
瓑	liWY
甅	liWZ
慄	liXQ
悡	liXS
悧	liXT
悷	liXU
鲤	liY
鳢	liYC
鱧	liYO
鲡	liYP
鯉	liYQ
鱺	liYS
鱱	liYT
叓	liYU
叕	liYV
謧	liYW
讈	liYX
鯏	liYY
鯬	liYZ
逦	liZ
迣	liZN
躒	liZO
跞	liZP
離	liZQ
歷	liZS
邐	liZT
邌	liZU
孷	liZV
歴	liZW
艃	liZX
貍	liZY
赲	liZZ
拢	longA
攏	longAQ
癃	longB
贚	longBQ
徿	longCQ
蠪	longCS
蠬	longCT
泷	longE
湰	longEQ
滝	longES
漋	longET
瀧	longEU
隆	longF
陇	longFC
聋	longFP
聾	longFQ
隴	longFS
豅	longGQ
爖	longHQ
栊	longI
梇	longIQ
槞	longIS
櫳	longIT
鏧	longJQ
鑨	longJS
笼	longK
籠	longKQ
篢	longKS
篭	longKT
襱	longKU
龙	longL
胧	longLP
朧	longLQ
龍	longLS
竜	longLT
龒	longLU
龓	longLV
眬	longMQ
矓	longMS
驡	longMT
鸗	longNQ
咙	longO
嚨	longOQ
哢	longOS
砻	longP
硦	longPQ
礱	longPS
礲	longPT
昽	longRQ
曨	longRS
霳	longRT
靇	longRU
屸	longSQ
嶐	longSS
巃	longST
巄	longSU
垄	longT
垅	longTP
壟	longTQ
壠	longTS
茏	longU
蘢	longUQ
儱	longVQ
珑	longW
瓏	longWQ
窿	longX
竉	longXQ
衖	longXS
尨	longYQ
躘	longZQ
搂	louA
摟	louAQ
瘘	louB
寠	louBQ
瘺	louBS
瘻	louBT
蝼	louCA
螻	louCQ
漏	louE
溇	louEQ
漊	louES
陋	louF
髅	louG
廔	louGQ
鞻	louGS
髏	louGT
熡	louHQ
楼	louI
樓	louIQ
镂	louJ
鏤	louJQ
篓	louK
簍	louKQ
耧	louL
耬	louLQ
瞜	louMQ
娄	louN
婁	louNQ
鷜	louNS
喽	louO
嘍	louOQ
屚	louPQ
露	louR
嶁	louSQ
嵝	louSR
軁	louSS
塿	louTQ
蒌	louU
蔞	louUQ
偻	louV
僂	louVQ
甊	louWQ
慺	louXQ
謱	louYQ
艛	louZQ
貗	louZS
遱	louZT
掳	luA
攣	luanAQ
癴	luanBQ
癵	luanBS
奱	luanDQ
滦	luanE
灓	luanEQ
灤	luanES
栾	luanI
欒	luanIQ
卵	luanJ
銮	luanJP
覶	luanJQ
釠	luanJS
鑾	luanJT
脟	luanLQ
臠	luanLS
臡	luanLT
鸾	luanN
娈	luanNP
孌	luanNQ
鵉	luanNS
鸞	luanNT
脔	luanR
曫	luanRQ
挛	luanS
峦	luanSP
巒	luanSQ
羉	luanSS
脔	luanT
薍	luanUQ
虊	luanUS
乱	luanV
亂	luanVQ
乿	luanVS
圝	luanWQ
圞	luanWS
孪	luanZ
孿	luanZQ
撸	luAP
摝	luAQ
擄	luAS
擼	luAT
攎	luAU
卢	luB
赂	luBC
卤	luBP
賂	luBQ
辘	luC
辂	luCC
轳	luCP
螰	luCQ
蠦	luCS
輅	luCT
轆	luCU
轤	luCV
剹	luDQ
漉	luE
掠	lueA
潞	luEC
寽	lueCQ
渌	luED
稤	lueHQ
锊	lueJ
鋝	lueJQ
鋢	lueJS
泸	luEP
滷	luEQ
淕	luES
略	lueT
畧	lueTQ
澛	luEU
瀂	luEV
瀘	luEW
圙	lueWQ
淥	luEX
陆	luF
陸	luFQ
緑	luFS
纑	luFT
罏	luFU
庐	luG
戮	luGP
廬	luGQ
廘	luGS
髗	luGT
炉	luH
虏	luHP
爐	luHQ
虜	luHS
熝	luHT
稑	luHU
穋	luHV
穞	luHW
穭	luHX
黸	luHY
橹	luI
栌	luIP
枦	luIQ
椂	luIS
樐	luIT
樚	luIU
櫓	luIV
櫨	luIW
镥	luJ
鏴	luJN
鏕	luJO
錄	luJQ
鑪	luJS
鑥	luJT
鐪	luJU
觻	luJV
鈩	luJW
録	luJX
錴	luJY
鏀	luJZ
簏	luK
箓	luKQ
簬	luKS
簵	luKT
簶	luKU
籙	luKV
籚	luKW
鹿	luL
胪	luLC
麓	luLP
勎	luLQ
勠	luLS
膔	luLT
臚	luLU
鹵	luLV
氇	luM
盧	luMQ
騼	luMS
氌	luMT
盝	luMU
睩	luMV
矑	luMW
粶	luMX
馿	luMY
騄	luMZ
鹭	luN
抡	lunA
掄	lunAQ
轮	lunC
輪	lunCQ
蜦	lunCS
沦	lunE
淪	lunEQ
溣	lunES
纶	lunF
綸	lunFQ
陯	lunFS
稐	lunHQ
棆	lunIQ
錀	lunJQ
耣	lunLQ
腀	lunLS
婨	lunNQ
鸬	luNP
碖	lunPQ
磮	lunPS
娽	luNQ
鴼	luNS
崘	lunSQ
崙	lunSS
鵦	luNT
埨	lunTQ
鵱	luNU
芲	lunUQ
菕	lunUS
伦	lunV
仑	lunVP
侖	lunVQ
倫	lunVS
鸕	luNW
圇	lunWQ
囵	lunWR
鷺	luNX
惀	lunXQ
论	lunY
論	lunYQ
鯩	lunYS
踚	lunZQ
噜	luO
摞	luoA
捰	luoAQ
擽	luoAS
攊	luoAT
攎	luoAU
攞	luoAV
攭	luoAW
瘰	luoB
癳	luoBQ
皪	luoBS
螺	luoC
寽	luoCQ
蛒	luoCS
剆	luoDQ
洛	luoE
漯	luoEC
泺	luoEP
洜	luoEQ
渃	luoES
濼	luoET
络	luoF
絡	luoFQ
纙	luoFS
烙	luoH
椤	luoI
欏	luoIQ
锣	luoJ
镙	luoJP
鑼	luoJQ
覶	luoJS
覼	luoJT
鏍	luoJU
裸	luoK
箩	luoKP
籮	luoKQ
笿	luoKS
脶	luoL
腡	luoLQ
臝	luoLS
骆	luoM
骡	luoMP
駱	luoMQ
騾	luoMS
犖	luoNQ
鵅	luoNS
鸁	luoNT
咯	luoO
啰	luoOQ
囉	luoOS
囖	luoOT
砢	luoPQ
硦	luoPS
磱	luoPT
嚕	luOQ
玀	luoQQ
猡	luoQR
曪	luoRQ
罗	luoS
羅	luoSQ
峈	luoSS
躶	luoST
饠	luoSU
蠃	luoT
驘	luoTQ
落	luoU
荦	luoUC
萝	luoUP
蘿	luoUQ
蓏	luoUS
倮	luoV
儸	luoVQ
珞	luoW
嚧	luOX
詻	luoYQ
頱	luoYS
鮥	luoYT
逻	luoZ
雒	luoZC
跞	luoZP
邏	luoZQ
躒	luoZS
碌	luP
硉	luPQ
硵	luPS
磟	luPT
磠	luPU
獹	luQQ
醁	luQS
露	luR
曥	luRQ
禄	luS
祿	luSQ
峍	luSS
垆	luT
圥	luTQ
坴	luTS
塶	luTT
塷	luTU
壚	luTV
芦	luU
蘆	luUQ
菉	luUS
蓾	luUT
蔍	luUU
蕗	luUV
虂	luUW
录	luV
侓	luVQ
僇	luVS
璐	luW
琭	luWQ
璷	luWS
瓐	luWT
彔	luXQ
玈	luXS
鲁	luY
鲈	luYC
颅	luYP
顱	luYQ
魯	luYS
甪	luYT
謢	luYU
魲	luYV
鯥	luYW
鱸	luYX
路	luZ
逯	luZC
舻	luZP
舮	luZQ
艣	luZS
艪	luZT
艫	luZU
趢	luZV
踛	luZW
蹗	luZX
捋	lvA
挔	lvAQ
捛	lvAS
律	lvC
滤	lvE
濾	lvEQ
绿	lvF
缕	lvFC
旅	lvFP
綠	lvFQ
縷	lvFS
絽	lvFT
緑	lvFU
繂	lvFV
郘	lvFW
虑	lvH
稆	lvHP
焒	lvHQ
爈	lvHS
穭	lvHT
榈	lvI
梠	lvIQ
櫖	lvIS
櫚	lvIT
铝	lvJ
鋁	lvJQ
鑢	lvJS
褛	lvK
箻	lvKQ
褸	lvKS
膂	lvL
勴	lvLQ
膐	lvLS
膟	lvLT
膢	lvLU
驴	lvM
闾	lvMP
驢	lvMQ
氀	lvMS
瞜	lvMT
閭	lvMU
鷜	lvNQ
吕	lvO
呂	lvOQ
哷	lvOS
履	lvP
屡	lvPP
屢	lvPQ
氯	lvQ
卛	lvSQ
嵂	lvSS
祣	lvST
垏	lvTQ
葎	lvUQ
藘	lvUS
侣	lvV
偻	lvVP
侶	lvVQ
僂	lvVS
儢	lvVT
率	lvX
慮	lvXQ
慺	lvXS
倆	lwVQ
抹	maA
痲	maBQ
痳	maBS
鬕	maBT
蚂	maC
蟆	maCP
螞	maCQ
蟇	maCS
溤	maEQ
杩	maI
買	maiBQ
賣	maiBS
脉	maiL
劢	maiLP
脈	maiLQ
勱	maiLS
麦	maiM
麥	maiMQ
鷶	maiNQ
嘪	maiOQ
榪	maIQ
霾	maiR
霡	maiRQ
霢	maiRS
卖	maiS
売	maiSQ
埋	maiT
荬	maiU
蕒	maiUQ
薶	maiUS
买	maiV
佅	maiVQ
衇	maiXQ
迈	maiZ
邁	maiZQ
鎷	maJQ
马	maM
骂	maMC
麽	maMD
麻	maMP
馬	maMQ
睰	maMS
閁	maMT
駡	maMU
妈	maN
摱	manAQ
鬗	manBQ
鬘	manBS
蛮	manC
螨	manCP
蠻	manCQ
蟎	manCS
满	manE
漫	manEP
滿	manEQ
満	manES
澫	manET
澷	manEU
缦	manF
絻	manFQ
縵	manFS
鄤	manFT
鞔	manG
痝	mangBQ
蟒	mangC
厖	mangCQ
蛖	mangCS
蠎	mangCT
漭	mangE
汒	mangEQ
浝	mangES
邙	mangF
庬	mangGQ
杗	mangIQ
杧	mangIS
釯	mangJQ
鋩	mangJS
铓	mangJT
笀	mangKQ
朚	mangLQ
盲	mangM
盳	mangMQ
駹	mangMS
娏	mangNQ
牤	mangNS
牻	mangNT
吂	mangOQ
哤	mangOS
硭	mangP
硥	mangPQ
匁	manGQ
狵	mangQQ
氓	mangS
壾	mangSQ
茫	mangU
莽	mangUC
芒	mangUP
茻	mangUQ
莾	mangUS
蘉	mangUT
忙	mangX
恾	mangXQ
尨	mangYQ
熳	manH
槾	manIQ
樠	manIS
幔	manJ
镘	manJP
鏋	manJQ
鏝	manJS
襔	manKQ
瞒	manM
瞞	manMQ
矕	manMS
娨	manNQ
嫚	manNS
屘	manPQ
媽	maNQ
獌	manQQ
曼	manR
馒	manS
饅	manSQ
犘	maNT
墁	manTR
蔓	manU
蔄	manUQ
蘰	manUT
嫲	maNV
僈	manVQ
鷌	maNW
慢	manX
悗	manXQ
慲	manXS
鳗	manY
颟	manYC
谩	manYP
謾	manYQ
顢	manYS
鰻	manYT
吗	maO
贸	maoB
髦	maoBP
貿	maoBQ
皃	maoBS
髳	maoBT
唛	maOC
蟊	maoCP
蝐	maoCQ
蝥	maoCR
軞	maoCS
泖	maoE
渵	maoEQ
旄	maoF
緢	maoFQ
鄚	maoFS
鄮	maoFT
戼	maoHQ
秏	maoHS
枆	maoIQ
柕	maoIS
楙	maoIT
帽	maoJ
铆	maoJC
卯	maoJD
锚	maoJP
錨	maoJQ
覒	maoJS
鉚	maoJT
鉾	maoJU
笷	maoKQ
毛	maoM
耄	maoMC
瞀	maoMD
矛	maoMP
毟	maoMQ
毷	maoMS
氂	maoMT
眊	maoMU
牦	maoN
媢	maoNQ
犛	maoNS
鶜	maoNT
嘛	maOP
嗎	maOQ
猫	maoQA
酕	maoQQ
昴	maoR
暓	maoRQ
嘜	maOS
嵍	maoSQ
峁	maoSR
罞	maoSS
冒	maoT
袤	maoTP
冇	maoTQ
冃	maoTS
冐	maoTT
堥	maoTU
茂	maoU
茆	maoUC
茅	maoUP
芼	maoUQ
萺	maoUS
蓩	maoUT
瑁	maoW
瓱	maoWQ
懋	maoX
夘	maoXQ
愗	maoXS
乮	maoYQ
貌	maoZ
貓	maoZQ
码	maP
碼	maPQ
犸	maQ
獁	maQQ
罵	maSQ
祃	maSS
禡	maST
菻	maUQ
蔴	maUS
亇	maVQ
傌	maVS
玛	maW
瑪	maWQ
鰢	maYQ
孖	maZQ
遤	maZS
濹	meEQ
庅	meGQ
抺	meiAQ
挴	meiAS
攗	meiAT
寐	meiB
凂	meiBQ
痗	meiBS
徾	meiCQ
蝞	meiCS
殙	meiDQ
没	meiE
浼	meiEC
湄	meiEP
沒	meiEQ
沬	meiES
渼	meiET
湈	meiEU
郿	meiFQ
魅	meiG
鬽	meiGQ
煤	meiH
煝	meiHQ
燘	meiHS
穈	meiHT
黣	meiHU
黴	meiHV
梅	meiI
楣	meiIC
枚	meiIP
栂	meiIQ
楳	meiIS
槑	meiIT
櫗	meiIU
镁	meiJ
镅	meiJP
鋂	meiJQ
鎂	meiJS
鎇	meiJT
袂	meiK
篃	meiKQ
脄	meiLQ
脢	meiLS
腜	meiLT
每	meiM
糜	meiMC
眉	meiMP
毎	meiMQ
眛	meiMS
睂	meiMT
睸	meiMU
妹	meiN
媚	meiNC
鹛	meiND
媒	meiNP
媄	meiNQ
媺	meiNS
嬍	meiNT
鶥	meiNU
嚜	meiOQ
酶	meiQ
猸	meiQP
霉	meiR
昧	meiRP
嵋	meiS
嵄	meiSQ
祙	meiSS
禖	meiST
躾	meiSU
坆	meiTQ
堳	meiTS
塺	meiTT
莓	meiU
苺	meiUQ
葿	meiUS
蘪	meiUT
玫	meiW
珻	meiWQ
瑂	meiWS
韎	meiWT
美	meiY
謎	meiYQ
羙	meiYS
跊	meiZQ
麼	meLQ
麽	meM
扪	menA
捫	menAQ
掹	mengAQ
擝	mengAS
髳	mengBQ
蜢	mengC
蠓	mengCC
虻	mengCP
蝱	mengCQ
溕	mengEQ
濛	mengES
鄳	mengFQ
鄸	mengFS
庬	mengGQ
梦	mengI
檬	mengIP
橗	mengIQ
锰	mengJ
錳	mengJQ
幪	mengJS
鋂	mengJT
朦	mengL
勐	mengLP
盟	mengM
冡	mengMQ
氋	mengMS
矇	mengMT
矒	mengMU
黽	mengMV
鼆	mengMW
鸏	mengNQ
鹲	mengNS
礞	mengP
猛	mengQ
獴	mengQQ
曚	mengRQ
雺	mengRS
霥	mengRT
霿	mengRU
靀	mengRV
饛	mengSQ
甿	mengTQ
蒙	mengU
甍	mengUC
瞢	mengUD
萌	mengUP
莔	mengUQ
蕄	mengUS
儚	mengVQ
懵	mengX
夢	mengXQ
夣	mengXS
懜	mengXT
懞	mengXU
尨	mengYQ
顭	mengYS
鯍	mengYT
鯭	mengYU
孟	mengZ
艋	mengZC
艨	mengZP
焖	menH
燜	menHQ
穈	menHS
椚	menIQ
钔	menJ
鍆	menJQ
门	menM
闷	menMP
門	menMQ
瞞	menMS
閅	menMT
暪	menRQ
亹	menTQ
菛	menUQ
虋	menUS
们	menV
們	menVQ
斖	menWQ
玧	menWS
璊	menWT
懑	menX
悶	menXQ
怋	menXS
悗	menXT
惛	menXU
懣	menXV
嚒	meOQ
嚜	meOS
嚰	meOT
么	meP
宀	mianBQ
蝒	mianCQ
免	mianD
沔	mianE
渑	mianEC
湎	mianEP
汅	mianEQ
澠	mianES
绵	mianF
缅	mianFP
綿	mianFQ
緬	mianFS
絻	mianFT
緜	mianFU
丏	mianHQ
棉	mianI
杣	mianIQ
檰	mianIS
櫋	mianIT
勉	mianL
腼	mianLP
勔	mianLQ
面	mianM
眄	mianMC
麪	mianMM
靦	mianMN
靣	mianMO
眠	mianMP
黽	mianMQ
麺	mianMS
麵	mianMT
麫	mianMU
睌	mianMV
矈	mianMW
矊	mianMX
矏	mianMY
糆	mianMZ
娩	mianN
婂	mianNQ
媔	mianNS
嬵	mianNT
喕	mianOQ
牑	mianPQ
冕	mianR
芇	mianUQ
莬	mianUS
葂	mianUT
俛	mianVQ
偭	mianVS
愐	mianXQ
鮸	mianYQ
臱	mianZQ
描	miaoA
渺	miaoE
淼	miaoEP
缪	miaoF
缈	miaoFP
緢	miaoFQ
緲	miaoFS
繆	miaoFT
庙	miaoG
廟	miaoGQ
庿	miaoGS
秒	miaoH
杪	miaoI
篎	miaoKQ
劰	miaoLQ
竗	miaoLS
瞄	miaoM
眇	miaoMP
妙	miaoN
鹋	miaoNP
媌	miaoNQ
嫹	miaoNS
鶓	miaoNT
喵	miaoO
厸	miaoSQ
苗	miaoU
藐	miaoUP
仯	miaoVQ
玅	miaoXQ
邈	miaoZ
摵	miAQ
擟	miAS
攠	miAT
宓	miB
宻	miBQ
镾	miBS
蜜	miC
鼏	miDQ
泌	miE
搣	mieAQ
蠛	mieC
滅	mieEQ
瀎	mieES
旀	mieFQ
灭	mieH
烕	mieHQ
櫗	mieIQ
沕	miEJ
幭	mieJQ
覕	mieJS
鑖	mieJT
篾	mieK
簚	mieKQ
滵	miEL
漞	miEM
眜	mieMQ
濔	miEN
鴓	mieNQ
咩	mieO
吀	mieOQ
哶	mieOS
汨	miEP
礣	miePQ
灖	miEQ
瀰	miES
濗	miET
蔑	mieU
薎	mieUQ
沵	miEV
洣	miEW
淧	miEX
懱	mieXQ
衊	mieXS
渳	miEY
鱴	mieYQ
乜	mieZ
孭	mieZQ
靡	miF
糸	miFQ
弥	miG
弭	miGP
彌	miGQ
秘	miH
熐	miHQ
爢	miHS
枈	miIQ
榓	miIS
樒	miIT
檷	miIU
櫁	miIV
觅	miJ
覓	miJQ
幎	miJS
幦	miJT
覔	miJU
覛	miJV
銤	miJW
簚	miKQ
袮	miKS
脒	miL
麋	miLP
麊	miLQ
麛	miLS
麿	miLT
米	miM
糜	miMC
幂	miMD
縻	miME
敉	miMF
眯	miMP
冪	miMQ
瞇	miMS
瞴	miMT
粎	miMU
冖	miMV
抿	minA
捪	minAQ
冺	minBQ
痻	minBS
賯	minBT
蠠	minCQ
刡	minDQ
泯	minE
渂	minEQ
湏	minES
湣	minET
潣	minEU
缗	minF
緍	minFQ
緡	minFS
掵	mingAQ
凕	mingBQ
螟	mingC
溟	mingE
洺	mingEQ
鄍	mingFQ
榠	mingIQ
椧	mingIS
铭	mingJ
銘	mingJQ
覭	mingJS
朙	mingLQ
冥	mingM
瞑	mingMP
眀	mingMQ
眳	mingMS
鸣	mingN
鳴	mingNQ
姳	mingNS
嫇	mingNT
命	mingO
名	mingOP
酩	mingQ
猽	mingQQ
明	mingR
暝	mingRP
茗	mingU
蓂	mingUQ
佲	mingVQ
慏	mingXQ
詺	mingYQ
鈱	minJQ
錉	minJS
鍲	minJT
笢	minKQ
笽	minKS
簢	minKT
勄	minLQ
闽	minM
闵	minMC
黾	minMD
皿	minMP
閩	minMQ
盿	minMS
閔	minMT
黽	minMU
姄	minNQ
鴖	minNS
呡	minOQ
砇	minPQ
碈	minPS
孊	miNQ
旻	minRQ
旼	minRS
暋	minRT
民	minS
岷	minSP
崏	minSQ
罠	minSS
鸍	miNT
垊	minTQ
苠	minU
僶	minVQ
敏	minW
珉	minWC
玟	minWP
敃	minWQ
敯	minWS
琘	minWT
琝	minWU
瑉	minWV
悯	minX
愍	minXP
憫	minXQ
忞	minXS
忟	minXT
怋	minXU
惽	minXV
慜	minXW
鳘	minY
鰵	minYQ
咪	miO
嘧	miOP
猕	miQ
獼	miQQ
醾	miQS
醿	miQT
釄	miQU
密	miS
芈	miSC
祢	miSP
峚	miSQ
祕	miSS
禰	miST
羃	miSU
塓	miTQ
缪	miuF
繆	miuFQ
葞	miUQ
蒾	miUS
蓂	miUT
蔝	miUU
蔤	miUV
藌	miUW
蘪	miUX
谬	miuY
謬	miuYQ
侎	miVQ
瓕	miWQ
怽	miXQ
戂	miXS
谜	miY
醚	miYC
谧	miYP
羋	miYQ
詸	miYS
謎	miYT
謐	miYU
迷	miZ
摸	moA
抹	moAC
摹	moAD
摩	moAP
擵	moAQ
攠	moAS
寞	moB
瘼	moBP
癦	moBQ
皌	moBS
抹	moC
蛨	moCQ
蟔	moCS
殁	moD
劘	moDQ
歾	moDS
歿	moDT
没	moE
沫	moEC
漠	moEP
沒	moEQ
瀎	moES
陌	moF
絈	moFQ
絔	moFS
縸	moFT
纆	moFU
魔	moG
庅	moGQ
靺	moGS
骳	moGT
髍	moGU
默	moH
秣	moHP
無	moHQ
爅	moHS
黙	moHT
模	moI
末	moIP
枺	moIQ
橅	moIS
唜	moIT
镆	moJ
帓	moJQ
帞	moJS
銆	moJT
鏌	moJU
袹	moKQ
脉	moL
耱	moLC
膜	moLP
麼	moLQ
麽	moM
眜	moMQ
眽	moMS
眿	moMT
瞐	moMU
瞙	moMV
糢	moMW
驀	moMX
嬷	moN
嫫	moNP
妺	moNQ
嫼	moNS
嬤	moNT
呒	moO
嗼	moOQ
嚜	moOS
嚤	moOT
磨	moP
砞	moPQ
礳	moPS
狢	moQQ
獏	moQS
昩	moRQ
馍	moS
饃	moSQ
饝	moSS
墨	moT
冐	moTQ
圽	moTS
塻	moTT
莫	moU
茉	moUC
蛑	mouCR
蓦	moUD
缪	mouF
繆	mouFQ
鞪	mouGQ
某	mouI
桙	mouIQ
鍪	mouJ
劺	mouLQ
眸	mouM
麰	mouMQ
牟	mouN
鴾	mouNQ
哞	mouO
呣	mouOQ
蘑	moUP
莈	moUQ
萬	moUS
藦	moUT
堥	mouTQ
侔	mouV
敄	mouWQ
恈	mouXQ
谋	mouY
謀	mouYQ
踎	mouZQ
尛	moXQ
懡	moXS
戂	moXT
衇	moXU
谟	moY
謨	moYQ
謩	moYS
魩	moYT
魹	moYU
貘	moZ
貊	moZP
貃	moZQ
貈	moZS
拇	muA
蚞	muCQ
沐	muE
縸	muFQ
繆	muFS
鞪	muGQ
穆	muH
炑	muHQ
木	muI
朷	muIQ
楘	muIS
樢	muIT
凩	muIU
朰	muIV
幕	muJ
钼	muJP
幙	muJQ
鉧	muJS
鉬	muJT
募	muL
胟	muLQ
母	muM
睦	muMC
毪	muMD
目	muMP
毣	muMQ
氁	muMS
牧	muN
牡	muNC
牟	muND
姆	muNP
娒	muNQ
牳	muNS
呣	muOQ
嘸	muOS
砪	muPQ
狇	muQQ
暮	muR
暯	muRQ
雮	muRS
霂	muRT
峔	muSQ
亩	muT
坶	muTC
墓	muTP
畝	muTQ
畂	muTS
畆	muTT
畒	muTU
畞	muTV
畮	muTW
苜	muU
莯	muUQ
仫	muV
慕	muX
慔	muXQ
艒	muZQ
踇	muZS
拿	naA
捺	naAP
抐	naAQ
拏	naAS
挐	naAT
搻	naAU
軜	naCQ
那	naF
纳	naFP
納	naFQ
郍	naFS
靹	naGQ
秅	naHQ
搱	naiAQ
摨	naiAS
疓	naiBQ
螚	naiCQ
奈	naiD
耐	naiE
渿	naiEQ
耏	naiES
柰	naiI
釢	naiJQ
銰	naiJS
錼	naiJT
褦	naiKQ
腉	naiLQ
奶	naiN
妳	naiNQ
嬭	naiNS
乃	naiP
氖	naiQ
萘	naiU
艿	naiUP
莻	naiUQ
佴	naiV
倷	naiVQ
廼	naiYQ
鼐	naiZ
孻	naiZQ
迺	naiZS
钠	naJ
镎	naJP
鈉	naJQ
鎿	naJS
衲	naK
笚	naKQ
笝	naKS
袦	naKT
肭	naL
娜	naN
抩	nanAQ
揇	nanAS
赧	nanC
蝻	nanCP
湳	nanEQ
攮	nangA
搑	nangAQ
擃	nangAS
齉	nangBQ
蠰	nangCQ
涳	nangEQ
瀼	nangES
灢	nangET
欜	nangIQ
囊	nangO
囔	nangOP
嚢	nangOQ
曩	nangR
馕	nangS
饢	nangSQ
乪	nangVQ
儾	nangVS
憹	nangXQ
煵	nanHQ
楠	nanI
枏	nanIQ
柟	nanIS
腩	nanL
妠	nanNQ
娚	nanNS
婻	nanNT
嫨	nanNU
喃	nanO
妠	naNQ
暔	nanRQ
南	nanS
男	nanT
畘	nanTQ
莮	nanUQ
萳	nanUS
侽	nanVQ
囡	nanW
囝	nanWP
戁	nanXQ
諵	nanYQ
难	nanZ
遖	nanZQ
難	nanZS
哪	naO
挠	naoA
撓	naoAQ
摎	naoAS
蛲	naoC
蟯	naoCQ
鬧	naoDQ
淖	naoE
匘	naoFQ
孬	naoH
橈	naoIQ
铙	naoJ
鐃	naoJQ
脑	naoL
腦	naoLQ
脳	naoLS
臑	naoLT
闹	naoM
閙	naoMQ
婥	naoNQ
嫐	naoNS
呶	naoO
呐	naOP
碙	naoPQ
硇	naoPR
碯	naoPS
吶	naOQ
獶	naoQQ
猱	naoQR
獿	naoQS
嗱	naOS
峱	naoSQ
嶩	naoSS
巎	naoST
垴	naoT
堖	naoTQ
瑙	naoW
恼	naoX
惱	naoXQ
怓	naoXS
悩	naoXT
憹	naoXU
詉	naoYQ
譊	naoYS
夒	naoZQ
蒘	naUQ
蒳	naUS
乸	naVQ
讷	naY
誽	naYQ
雫	naYS
魶	naYT
豽	naZQ
貀	naZS
抐	neAQ
疒	neBQ
浽	neiEQ
錗	neiJQ
脮	neiLQ
腇	neiLS
娞	neiNQ
氝	neiQQ
氞	neiQS
內	neiRQ
馁	neiS
餒	neiSQ
餧	neiSS
内	neiT
鮾	neiYQ
鯘	neiYS
眲	neMQ
螚	nengCQ
能	nengL
媆	nenNS
嫰	nenNT
恁	nenX
呢	neO
吶	neOQ
讷	neY
訥	neYQ
拟	niA
撵	nianA
拈	nianAC
捻	nianAP
攆	nianAQ
撚	nianAS
辇	nianC
輦	nianCQ
輾	nianCS
涊	nianEQ
淰	nianES
溓	nianET
娘	niangN
嬢	niangNQ
孃	niangNS
酿	niangQ
釀	niangQQ
醸	niangQS
廿	nianH
黏	nianHP
秊	nianHQ
秥	nianHS
秊	nianHT
焾	nianHU
榐	nianIQ
簐	nianKQ
粘	nianM
姩	nianNQ
鵇	nianNS
哖	nianOQ
唸	nianOS
年	nianP
碾	nianPP
卄	nianSQ
埝	nianT
蔫	nianU
念	nianX
悥	nianXQ
惗	nianXS
鲶	nianY
鲇	nianYP
鮎	nianYQ
鯰	nianYS
艌	nianZQ
蹍	nianZS
蹨	nianZT
躎	nianZU
樢	niaoIQ
袅	niaoK
裊	niaoKQ
褭	niaoKS
脲	niaoL
鸟	niaoN
嬲	niaoNP
鳥	niaoNQ
嫋	niaoNS
嬝	niaoNT
尿	niaoP
茑	niaoU
蔦	niaoUQ
擬	niAQ
抐	niAS
抳	niAT
掜	niAU
蚭	niCQ
蛪	niCS
蜺	niCT
輗	niCU
齯	niCV
泥	niE
捏	nieA
攝	nieAQ
掜	nieAS
揑	nieAT
摰	nieAU
痆	nieBQ
蠥	nieCQ
齧	nieCS
涅	nieE
湼	nieEQ
聂	nieF
陧	nieFP
聶	nieFQ
隉	nieFS
枿	nieIQ
槷	nieIS
櫱	nieIT
镍	nieJ
镊	nieJP
帇	nieJQ
銸	nieJS
鋷	nieJT
錜	nieJU
鎳	nieJV
鑈	nieJW
鑷	nieJX
钀	nieJY
篞	nieKQ
籋	nieKS
糱	nieMQ
糵	nieMS
闑	nieMT
啮	nieO
嗫	nieOP
噛	nieOQ
嚙	nieOS
囁	nieOT
囐	nieOU
囓	nieOV
溺	niEP
兒	niEQ
氼	niES
峊	nieSQ
嵲	nieSS
嶭	nieST
巕	nieSU
淣	niET
圼	nieTQ
濔	niEU
苶	nieUQ
蘖	nieUR
菍	nieUS
敜	nieWQ
颞	nieY
讘	nieYQ
顳	nieYS
孽	nieZ
乜	nieZC
臬	nieZD
蹑	nieZP
孼	nieZQ
臲	nieZS
踂	nieZT
踗	nieZU
踙	nieZV
躡	nieZW
匿	niF
旎	niFP
縌	niFQ
聣	niFS
聻	niFT
郳	niFU
隬	niFV
秜	niHQ
柅	niIQ
棿	niIS
檷	niIT
铌	niJ
觬	niJQ
鈮	niJS
腻	niL
膩	niLQ
胒	niLS
臡	niLT
麑	niLU
睨	niM
眤	niMQ
籾	niMS
妮	niN
拰	ninAQ
拧	ningA
擰	ningAQ
宁	ningB
甯	ningBC
凝	ningBP
寍	ningBQ
寕	ningBS
寗	ningBT
寜	ningBU
寧	ningBV
鬡	ningBW
泞	ningE
濘	ningEQ
澝	ningES
聍	ningF
聹	ningFQ
柠	ningI
檸	ningIQ
橣	ningIS
鑏	ningJQ
矃	ningMQ
嬣	ningNQ
鸋	ningNS
咛	ningO
嚀	ningOQ
狞	ningQ
獰	ningQQ
苧	ningUQ
薴	ningUS
佞	ningV
侫	ningVQ
倿	ningVS
儜	ningVT
脌	ninLQ
妳	niNQ
婗	niNS
嫟	niNT
嬺	niNU
囜	ninWQ
您	ninX
尼	niP
屔	niPQ
猊	niQ
狔	niQQ
霓	niR
昵	niRP
晲	niRQ
暱	niRS
屰	niSQ
坭	niT
埿	niTQ
堄	niTS
蘼	niU
扭	niuA
拗	niuAP
抝	niuAQ
汼	niuEQ
沑	niuES
纽	niuF
紐	niuFQ
靵	niuGQ
炄	niuHQ
杻	niuIQ
钮	niuJ
鈕	niuJQ
牛	niuN
妞	niuNP
牜	niuNQ
苨	niUQ
狃	niuQR
薿	niUS
莥	niuUQ
忸	niuX
怓	niuXQ
你	niV
伲	niVC
倪	niVP
伱	niVQ
儗	niVS
儞	niVT
怩	niX
惄	niXQ
愵	niXS
懝	niXT
馜	niXU
鲵	niY
誽	niYQ
鯢	niYS
逆	niZ
孴	niZQ
貎	niZS
跜	niZT
挊	nongAQ
挵	nongAS
癑	nongBQ
鬞	nongBS
齈	nongBT
農	nongCQ
辳	nongCS
浓	nongE
濃	nongEQ
繷	nongFQ
弄	nongG
燶	nongHQ
秾	nongHS
穠	nongHT
檂	nongIQ
欁	nongIS
襛	nongKQ
脓	nongL
膿	nongLQ
农	nongM
哝	nongO
噥	nongOQ
醲	nongQQ
禯	nongSQ
蕽	nongUQ
侬	nongV
儂	nongVQ
譨	nongYQ
搙	nouAQ
槈	nouIQ
檽	nouIS
鎒	nouJQ
鐞	nouJS
耨	nouL
獳	nouQQ
羺	nouYQ
渜	nuanEQ
湪	nuanES
煖	nuanHQ
煗	nuanHS
奻	nuanNQ
暖	nuanR
餪	nuanSQ
搙	nuAQ
疟	nueB
瘧	nueBQ
虐	nueH
婩	nueNQ
硸	nuePQ
弩	nuG
笯	nuKQ
努	nuL
驽	nuM
駑	nuMQ
奴	nuN
黁	nunLQ
嫩	nunN
胬	nuNP
挪	nuoA
搦	nuoAP
挼	nuoAQ
掿	nuoAS
搙	nuoAT
搻	nuoAU
耎	nuoEQ
稬	nuoHQ
穤	nuoHS
梛	nuoIQ
榒	nuoIS
橠	nuoIT
锘	nuoJ
鍩	nuoJQ
袲	nuoKQ
袳	nuoKS
糯	nuoM
毭	nuoMQ
糑	nuoMS
糥	nuoMT
娜	nuoN
喏	nuoO
傩	nuoV
儺	nuoVQ
懦	nuoX
愞	nuoXQ
懧	nuoXS
诺	nuoY
諾	nuoYQ
詝	nuoYS
難	nuoZQ
蹃	nuoZS
逽	nuoZT
砮	nuPQ
伮	nuVQ
傉	nuVS
怒	nuX
孥	nuZ
沑	nvEQ
聏	nvFQ
钕	nvJ
釹	nvJQ
朒	nvLQ
籹	nvMQ
女	nvN
衄	nvX
恧	nvXP
衂	nvXQ
哦	oO
噢	oOP
嚄	oOQ
沤	ouE
漚	ouEQ
區	ouFQ
髃	ouGQ
熰	ouHQ
櫙	ouIQ
鏂	ouJQ
筽	ouKQ
耦	ouL
腢	ouLQ
膒	ouLS
鸥	ouN
鷗	ouNQ
鴎	ouNS
呕	ouO
嘔	ouOQ
吘	ouOS
吽	ouOT
殴	ouP
毆	ouPQ
欧	ouQ
歐	ouQQ
塸	ouTQ
藕	ouU
蕅	ouUQ
藲	ouUS
偶	ouV
瓯	ouW
甌	ouWQ
怄	ouX
慪	ouXQ
讴	ouY
謳	ouYQ
扒	paA
掱	paAQ
琶	paB
皅	paBQ
皅	paBT
汃	paEQ
潖	paES
杷	paI
排	paiA
拍	paiAP
徘	paiC
輫	paiCQ
派	paiE
湃	paiEP
沠	paiEQ
渒	paiES
棑	paiIQ
鎃	paiJQ
箄	paiKQ
簰	paiKS
簲	paiKT
闏	paiMQ
哌	paiO
牌	paiP
猅	paiQQ
蒎	paiU
俳	paiV
廹	paiYQ
帕	paJ
帊	paJQ
鈀	paJS
筢	paK
袙	paKQ
耙	paL
攀	panA
拚	panAP
搫	panAQ
冸	panBQ
蟠	panC
判	panD
潘	panE
泮	panEP
沜	panEQ
洀	panES
湴	panET
溿	panEU
瀊	panEV
縏	panFQ
髣	pangBQ
螃	pangC
彷	pangCP
厐	pangCQ
徬	pangCS
滂	pangE
汸	pangEQ
沗	pangES
旁	pangF
庞	pangG
庬	pangGQ
髈	pangGS
炐	pangHQ
覫	pangJQ
篣	pangKQ
胖	pangL
耪	pangLP
龐	pangLQ
肨	pangLS
胮	pangLT
膖	pangLU
龎	pangLV
眫	pangMQ
嫎	pangNQ
嗙	pangOQ
乓	pangP
磅	pangPP
鞶	panGQ
雱	pangRQ
霶	pangRS
攵	pangW
尨	pangYQ
鰟	pangYS
鳑	pangYT
逄	pangZ
夂	pangZP
夆	pangZQ
舽	pangZS
趽	pangZT
炍	panHQ
柈	panIQ
槃	panIS
幋	panJQ
鋬	panJS
鎜	panJT
鑻	panJU
袢	panK
襻	panKP
籓	panKQ
胖	panL
肨	panLQ
膰	panLS
盘	panM
盼	panMP
盤	panMQ
盻	panMS
眅	panMT
眫	panMU
闆	panMV
媻	panNQ
鵥	panNS
磐	panP
爿	panPP
牉	panPQ
磻	panPS
丬	panPT
妑	paNQ
畔	panT
坢	panTQ
畨	panTS
萠	panUQ
蒰	panUS
叛	panY
詊	panYQ
頖	panYS
蹒	panZ
跘	panZQ
蹣	panZS
啪	paO
抛	paoA
拋	paoAQ
疱	paoB
軳	paoCQ
刨	paoD
匏	paoDP
奅	paoDQ
泡	paoE
庖	paoG
瓟	paoGQ
鞄	paoGS
炮	paoH
炰	paoHQ
烰	paoHS
穮	paoHT
鉋	paoJQ
鑤	paoJS
袍	paoK
袌	paoKQ
褜	paoKS
脬	paoL
麃	paoLQ
麅	paoLS
靤	paoMQ
麭	paoMS
咆	paoO
嚗	paoOQ
皰	paoPQ
砲	paoPS
礟	paoPT
礮	paoPU
狍	paoQ
垉	paoTQ
萢	paoUQ
藨	paoUS
跑	paoZ
爮	paoZQ
跁	paoZS
葩	paU
苩	paUQ
怕	paX
爬	paZ
趴	paZP
舥	paZQ
抷	peiAQ
攈	peiAS
赔	peiB
賠	peiBQ
轡	peiCQ
沛	peiE
浿	peiEQ
陪	peiF
旆	peiFP
斾	peiFQ
阫	peiFS
柭	peiIQ
柸	peiIS
棑	peiIT
帔	peiJ
锫	peiJP
錇	peiJQ
裴	peiK
裵	peiKQ
裶	peiKS
胚	peiL
肧	peiLQ
毰	peiMQ
馷	peiMS
妚	peiNQ
姵	peiNS
婄	peiNT
媐	peiNU
呸	peiO
辔	peiOP
配	peiQ
醅	peiQP
犻	peiQQ
霈	peiR
嶏	peiSQ
培	peiT
蓜	peiUQ
佩	peiV
伂	peiVQ
俖	peiVS
珮	peiWQ
琣	peiWS
怌	peiXQ
衃	peiXS
湓	penE
濆	penEQ
捧	pengA
抨	pengAP
挷	pengAQ
捀	pengAS
掽	pengAT
搒	pengAU
摓	pengAV
匉	pengBQ
痭	pengBS
皏	pengBT
髼	pengBU
鬅	pengBV
鬔	pengBW
蟛	pengC
蟚	pengCQ
軯	pengCS
輣	pengCT
輧	pengCU
剻	pengDQ
澎	pengE
泙	pengEQ
淎	pengES
淜	pengET
漨	pengEU
漰	pengEV
絣	pengFQ
纄	pengFS
弸	pengGQ
烹	pengH
熢	pengHQ
稝	pengHS
棚	pengI
梈	pengIQ
椖	pengIS
椪	pengIT
槰	pengIU
樥	pengIV
錋	pengJQ
鑝	pengJS
篷	pengK
竼	pengKQ
篣	pengKS
袶	pengKT
朋	pengL
膨	pengLP
胓	pengLQ
閛	pengMQ
駍	pengMS
騯	pengMT
鹏	pengN
鵬	pengNQ
嘭	pengO
碰	pengP
硼	pengPC
砰	pengPP
硑	pengPQ
磞	pengPS
彭	pengS
堋	pengT
塜	pengTQ
塳	pengTS
蓬	pengU
芃	pengUQ
莑	pengUS
蘕	pengUT
伻	pengVQ
倗	pengVS
傰	pengVT
怦	pengX
恲	pengXQ
憉	pengXS
韸	pengYQ
韼	pengYS
踫	pengZQ
盆	penM
喷	penO
噴	penOQ
呠	penOS
喯	penOT
歕	penQQ
葐	penUQ
瓫	penWQ
翸	penYQ
啤	peO
批	piA
擗	piAC
貵	pianBQ
賆	pianBS
緶	pianFQ
骿	pianGQ
楄	pianIQ
楩	pianIS
覑	pianJQ
篇	pianK
胼	pianL
腁	pianLQ
骗	pianM
骈	pianMP
騙	pianMQ
駢	pianMS
騈	pianMT
騗	pianMU
犏	pianN
媥	pianNQ
鶣	pianNS
片	pianP
猵	pianQQ
獱	pianQS
便	pianV
偏	pianVP
囨	pianWQ
瑸	pianWS
璸	pianWT
翩	pianY
谝	pianYP
諞	pianYQ
魸	pianYS
蹁	pianZ
跰	pianZQ
皫	piaoBQ
螵	piaoC
徱	piaoCQ
剽	piaoD
殍	piaoDP
漂	piaoE
飘	piaoF
缥	piaoFP
飄	piaoFQ
旚	piaoFS
縹	piaoFT
飃	piaoFU
瓢	piaoG
魒	piaoGQ
篻	piaoKQ
勡	piaoLQ
瞟	piaoM
闝	piaoMQ
驃	piaoMS
嫖	piaoN
犥	piaoNQ
嘌	piaoO
醥	piaoQQ
票	piaoS
彯	piaoSQ
莩	piaoU
薸	piaoUQ
僄	piaoVQ
慓	piaoXQ
翲	piaoYQ
顠	piaoYS
鰾	piaoYT
披	piAP
抷	piAQ
揊	piAS
疲	piB
癖	piBC
痞	piBD
琵	piBP
毘	piBQ
髬	piBS
蜱	piC
蚍	piCP
蚽	piCQ
蚾	piCS
螕	piCT
螷	piCU
蠯	piCV
劈	piD
淠	piE
撇	pieA
撆	pieAQ
潎	pieEQ
覕	pieJQ
鐅	pieJS
瞥	pieM
嫳	pieNQ
丿	pieP
潎	piEQ
氕	pieQR
暼	pieRQ
澼	piES
彡	pieSR
苤	pieU
匹	piF
纰	piFC
郫	piFD
陴	piFE
邳	piFP
旇	piFQ
紕	piFS
阰	piFT
隦	piFU
鼙	piG
庀	piGP
鞞	piGQ
丕	piH
炋	piHQ
焷	piHS
秛	piHT
秠	piHU
稫	piHV
枇	piI
枈	piIQ
椑	piIS
榌	piIT
铍	piJ
鎞	piJQ
釽	piJS
鈚	piJT
鈹	piJU
鉟	piJV
銔	piJW
銢	piJX
錃	piJY
錍	piJZ
被	piK
笓	piKQ
篺	piKS
脾	piL
耚	piLQ
肶	piLS
脴	piLT
腗	piLU
膍	piLV
闢	piMQ
駓	piMS
媲	piN
拼	pinA
贫	pinB
貧	pinBQ
蠙	pinCQ
汖	pinEQ
聘	pinF
冯	pingB
蚲	pingCQ
蛢	pingCS
軿	pingCT
泙	pingEQ
洴	pingES
涄	pingET
淜	pingEU
缾	pingFQ
聠	pingFS
郱	pingFT
庰	pingGQ
平	pingH
焩	pingHQ
枰	pingI
檘	pingIQ
凭	pingJ
凴	pingJQ
帡	pingJS
帲	pingJT
幈	pingJU
箳	pingKQ
簈	pingKS
竮	pingLQ
胓	pingLS
馮	pingMQ
娉	pingN
呯	pingOQ
屏	pingP
乒	pingPP
屛	pingPQ
砯	pingPS
硑	pingPT
岼	pingSQ
坪	pingT
塀	pingTQ
甹	pingTS
苹	pingU
萍	pingUP
蘋	pingUQ
荓	pingUS
蓱	pingUT
俜	pingV
瓶	pingW
玶	pingWQ
甁	pingWS
憑	pingXQ
慿	pingXS
评	pingY
鲆	pingYP
評	pingYQ
頩	pingYS
鮃	pingYT
艵	pingZQ
穦	pinHQ
榀	pinI
朩	pinIQ
矉	pinMQ
驞	pinMS
嫔	pinN
牝	pinNC
姘	pinNP
娦	pinNQ
嬪	pinNS
品	pinO
嚬	pinOQ
砏	pinPQ
礗	pinPS
妚	piNQ
嫓	piNS
鴄	piNT
鵧	piNU
薲	pinUQ
蘋	pinUS
鷿	piNV
鸊	piNW
玭	pinWQ
琕	pinWS
馪	pinXQ
频	pinY
颦	pinYP
頻	pinYQ
顰	pinYS
否	piO
噼	piOC
啤	piOP
噽	piOQ
嚊	piOS
嚭	piOT
皮	piP
砒	piPC
屁	piPP
磇	piPQ
礔	piPS
礕	piPT
狉	piQQ
狓	piQS
猈	piQT
霹	piR
朇	piRQ
罴	piS
罷	piSQ
岯	piSS
崥	piST
嶏	piSU
禆	piSV
羆	piSW
坯	piT
圮	piTC
埤	piTD
毗	piTP
壀	piTQ
疈	piTS
芘	piU
苉	piUQ
僻	piV
仳	piVP
伓	piVQ
伾	piVS
甓	piW
辟	piX
怶	piXQ
悂	piXS
憵	piXT
譬	piY
翍	piYQ
諀	piYS
魮	piYT
魾	piYU
鮍	piYV
鲏	piYW
貔	piZ
疋	piZP
豼	piZQ
豾	piZS
掊	poA
搫	poAQ
皤	poB
髲	poBQ
尀	poCQ
奤	poDQ
泼	poE
潑	poEQ
洦	poES
湐	poET
濼	poEU
溌	poEV
鄱	poF
叵	poFP
魄	poG
烞	poHQ
桲	poIQ
櫇	poIS
钋	poJ
钷	poJP
釙	poJQ
鉕	poJS
鏺	poJT
笸	poK
箥	poKQ
粕	poM
駊	poMQ
婆	poN
哱	poOQ
嘙	poOS
嚩	poOT
破	poP
颇	poPP
砶	poPQ
猼	poQQ
酦	poQS
醗	poQT
醱	poQU
昢	poRQ
岥	poSQ
岶	poSS
坡	poT
掊	pouA
抔	pouAQ
抙	pouAS
捊	pouAT
剖	pouD
棓	pouIQ
箁	pouKQ
娝	pouNQ
婄	pouNS
犃	pouNT
咅	pouOQ
哣	pouOS
蒪	poUQ
蔢	poUS
裒	pouT
垺	pouTQ
珀	poW
敀	poWQ
覇	poXQ
頗	poYQ
廹	poYS
翍	poYT
迫	poZ
扑	puA
撲	puAQ
抪	puAS
捗	puAT
擈	puAU
匍	puB
痡	puBQ
贌	puBS
浦	puE
溥	puEC
濮	puED
瀑	puEP
潽	puEQ
瀑	puF
巬	puFQ
纀	puFS
陠	puFT
曝	puG
炇	puHQ
烳	puHS
秿	puHT
穙	puHU
朴	puI
樸	puIQ
柨	puIS
檏	puIT
铺	puJ
镨	puJC
镤	puJP
鋪	puJQ
鏷	puJS
鐠	puJT
箁	puKQ
氆	puM
毬	puMQ
瞨	puMS
噗	puO
攴	puPQ
獛	puQQ
酺	puQS
普	puR
曝	puRC
暴	puRP
暜	puRQ
舖	puSQ
舗	puSS
埔	puT
圤	puTQ
墣	puTS
葡	puU
菩	puUC
莆	puUD
蒲	puUP
菐	puUQ
蒱	puUS
仆	puV
僕	puVQ
圃	puW
璞	puWP
圑	puWQ
谱	puY
譜	puYQ
諩	puYS
鯆	puYT
蹼	puZ
掐	qiaA
抲	qiaAQ
拤	qiaAS
揢	qiaAT
擖	qiaAU
冾	qiaBQ
夹	qiaD
殎	qiaDQ
洽	qiaE
匼	qiaFQ
髂	qiaG
鞐	qiaGQ
帢	qiaJQ
袷	qiaK
胢	qiaLQ
扦	qianA
摼	qianAL
揵	qianAM
掔	qianAN
掅	qianAO
掮	qianAP
攓	qianAQ
攑	qianAS
攐	qianAT
撍	qianAU
撁	qianAV
扲	qianAW
拑	qianAX
拪	qianAY
挳	qianAZ
骞	qianB
褰	qianBC
搴	qianBP
皘	qianBQ
鬜	qianBS
鬝	qianBT
厱	qianCQ
臤	qianCS
蚈	qianCT
蚙	qianCU
蜸	qianCV
軡	qianCW
輤	qianCX
前	qianD
刋	qianDQ
潜	qianE
浅	qianEP
淺	qianEQ
潛	qianES
汘	qianET
汧	qianEU
濳	qianEV
灊	qianEW
纤	qianF
缱	qianFC
阡	qianFP
綪	qianFQ
縴	qianFS
繾	qianFT
抢	qiangA
搶	qiangAQ
摤	qiangAS
摪	qiangAT
羌	qiangB
蜣	qiangC
將	qiangCQ
溬	qiangEQ
漒	qiangES
繈	qiangFQ
繦	qiangFS
强	qiangG
戗	qiangGP
強	qiangGQ
廧	qiangGS
彊	qiangGT
戧	qiangGU
炝	qiangH
熗	qiangHQ
枪	qiangI
樯	qiangIP
槍	qiangIQ
椌	qiangIS
檣	qiangIT
锵	qiangJ
镪	qiangJC
锖	qiangJP
斨	qiangJQ
錆	qiangJS
鎗	qiangJT
鏘	qiangJU
鏹	qiangJV
襁	qiangK
篬	qiangKQ
腔	qiangL
嫱	qiangN
嬙	qiangNQ
鶬	qiangNS
呛	qiangO
嗆	qiangOQ
唴	qiangOS
啌	qiangOT
嗴	qiangOU
将	qiangP
戕	qiangPP
牆	qiangPQ
牄	qiangPS
矼	qiangPT
谸	qianGQ
猐	qiangQQ
獇	qiangQS
靬	qianGS
嶈	qiangSQ
墙	qiangT
墏	qiangTQ
韆	qianGTR
墻	qiangTS
蔷	qiangU
蔃	qiangUQ
薔	qiangUS
蘠	qiangUT
玱	qiangWQ
瑲	qiangWS
羟	qiangY
羗	qiangYQ
羥	qiangYS
羫	qiangYT
羻	qiangYU
謒	qiangYV
跄	qiangZ
艢	qiangZQ
蹌	qiangZS
蹡	qiangZT
黔	qianH
黔	qianHP
炶	qianHQ
煔	qianHS
黚	qianHT
椠	qianI
杄	qianIQ
棈	qianIS
榩	qianIT
槏	qianIU
槧	qianIV
橬	qianIW
檶	qianIX
櫏	qianIY
钱	qianJ
钳	qianJC
钎	qianJD
钤	qianJE
鑓	qianJO
铅	qianJP
鉗	qianJQ
錢	qianJS
鏲	qianJT
釺	qianJU
鈆	qianJV
鈐	qianJW
鉛	qianJX
銭	qianJY
鎆	qianJZ
签	qianK
箝	qianKP
簽	qianKQ
兛	qianKS
篏	qianKT
篟	qianKU
籖	qianKV
籤	qianKW
凵	qianKX
肷	qianL
竏	qianLQ
膁	qianLS
粁	qianMQ
騚	qianMS
騝	qianMT
騫	qianMU
牵	qianN
牽	qianNQ
鹐	qianNS
奷	qianNT
婜	qianNU
媊	qianNV
嬱	qianNW
孅	qianNX
鳽	qianNY
鵮	qianNZ
唊	qianOQ
嗛	qianOS
千	qianP
磏	qianPQ
欠	qianQ
歉	qianQP
欦	qianQQ
欿	qianQS
朁	qianRQ
嵌	qianS
岍	qianSP
岒	qianSQ
嵰	qianSS
堑	qianT
圱	qianTQ
圲	qianTS
塹	qianTT
墘	qianTU
壍	qianTV
茜	qianU
芊	qianUC
芡	qianUD
荨	qianUP
茾	qianUQ
葥	qianUS
蒨	qianUT
蔳	qianUU
蕁	qianUV
乾	qianV
佥	qianVC
仟	qianVD
倩	qianVP
儙	qianVQ
乹	qianVS
亁	qianVT
仱	qianVU
伣	qianVV
俔	qianVW
偂	qianVX
傔	qianVY
僉	qianVZ
瓩	qianWQ
玪	qianWS
愆	qianX
慊	qianXC
悭	qianXP
忴	qianXQ
悓	qianXS
慳	qianXT
谦	qianY
谴	qianYP
謙	qianYQ
谴	qianYR
譴	qianYS
羬	qianYT
諐	qianYU
顅	qianYV
鰬	qianYW
迁	qianZ
遣	qianZP
遷	qianZQ
孯	qianZS
歬	qianZT
撬	qiaoA
摮	qiaoAQ
撽	qiaoAS
癄	qiaoBQ
削	qiaoD
劁	qiaoDP
潐	qiaoEQ
缲	qiaoF
繑	qiaoFQ
繰	qiaoFS
郻	qiaoFT
鄡	qiaoFU
鄥	qiaoFV
陗	qiaoFW
巧	qiaoG
鞘	qiaoGC
鞒	qiaoGD
敲	qiaoGP
鞩	qiaoGQ
鞽	qiaoGS
骹	qiaoGT
髚	qiaoGU
髜	qiaoGV
丂	qiaoHQ
燆	qiaoHS
燋	qiaoHT
桥	qiaoI
橇	qiaoIC
樵	qiaoIP
橋	qiaoIQ
槗	qiaoIS
橾	qiaoIT
櫵	qiaoIU
锹	qiaoJ
鍬	qiaoJQ
鐰	qiaoJS
帩	qiaoJT
幓	qiaoJU
幧	qiaoJV
釥	qiaoJW
鍫	qiaoJX
鏒	qiaoJY
鐈	qiaoJZ
箾	qiaoKQ
勪	qiaoLQ
瞧	qiaoM
睄	qiaoMQ
嫶	qiaoNQ
犞	qiaoNS
喬	qiaoOQ
喿	qiaoOS
嘺	qiaoOT
噭	qiaoOU
乔	qiaoP
硗	qiaoPP
殼	qiaoPQ
礉	qiaoPS
殻	qiaoPT
毃	qiaoPU
硚	qiaoPV
碻	qiaoPW
磝	qiaoPX
磽	qiaoPY
礄	qiaoPZ
壳	qiaoS
峤	qiaoSC
峭	qiaoSP
嵪	qiaoSQ
嶠	qiaoSS
墝	qiaoTQ
墧	qiaoTS
墽	qiaoTT
荞	qiaoU
荍	qiaoUQ
菬	qiaoUS
蕎	qiaoUT
藮	qiaoUU
侨	qiaoV
俏	qiaoVP
僑	qiaoVQ
偢	qiaoVS
僺	qiaoVT
韒	qiaoWQ
悄	qiaoX
憔	qiaoXC
愀	qiaoXD
窍	qiaoXP
竅	qiaoXQ
翘	qiaoY
谯	qiaoYC
诮	qiaoYP
翹	qiaoYQ
誚	qiaoYS
譙	qiaoYT
頝	qiaoYU
顦	qiaoYV
跷	qiaoZ
蹺	qiaoZQ
趫	qiaoZS
趬	qiaoZT
踍	qiaoZU
蹻	qiaoZV
躈	qiaoZW
硈	qiaPQ
磍	qiaPS
扱	qiAQ
酠	qiaQQ
捿	qiAS
峠	qiaSQ
掑	qiAT
圶	qiaTQ
摖	qiAU
葜	qiaUR
恰	qiaX
愘	qiaXQ
跒	qiaZQ
其	qiB
凄	qiBP
疧	qiBQ
鬐	qiBS
蛴	qiC
蜞	qiCP
軝	qiCQ
蚑	qiCS
蚔	qiCT
蚚	qiCU
蜝	qiCV
螇	qiCW
螧	qiCX
蟿	qiCY
蠐	qiCZ
奇	qiD
契	qiDP
豈	qiDQ
剘	qiDS
汽	qiE
挈	qieA
癿	qieBQ
泣	qiEC
厒	qieCQ
蛪	qieCS
切	qieD
淇	qiEE
洯	qieEQ
淁	qieES
汔	qiEF
匧	qieFQ
郄	qieFR
聺	qieFS
沏	qiEG
且	qieH
稧	qieHQ
穕	qieHS
栔	qieIQ
椄	qieIS
锲	qieJ
帹	qieJQ
鍥	qieJS
箧	qieK
笡	qieKQ
篋	qieKS
籡	qieKT
妾	qieN
洓	qiEO
嗛	qieOQ
漆	qiEP
亝	qiEQ
猰	qieQQ
朅	qieRQ
淒	qiET
湆	qiEU
茄	qieUA
苆	qieUQ
湇	qiEV
滊	qiEW
窃	qieX
惬	qieXC
慊	qieXD
怯	qieXP
竊	qieXQ
悏	qieXS
愜	qieXT
濝	qiEY
鯜	qieYQ
趄	qieZ
疌	qieZQ
跙	qieZS
踥	qieZT
旗	qiF
绮	qiFC
綦	qiFD
罊	qiFL
緀	qiFM
綺	qiFN
綨	qiFO
缉	qiFP
緝	qiFQ
隑	qiFS
陭	qiFT
鄿	qiFU
郪	qiFV
邔	qiFW
旂	qiFX
紪	qiFY
綥	qiFZ
弃	qiG
戚	qiGP
鬿	qiGQ
魌	qiGS
七	qiH
亓	qiHP
炁	qiHQ
焏	qiHS
稘	qiHT
丌	qiHU
棋	qiI
杞	qiIC
槭	qiID
柒	qiIE
桤	qiIF
榿	qiIO
栖	qiIP
棄	qiIQ
櫀	qiIS
檱	qiIT
栔	qiIU
桼	qiIV
梩	qiIW
棊	qiIX
棨	qiIY
棲	qiIZ
缉	qiJ
帺	qiJQ
觭	qiJS
釮	qiJT
錡	qiJU
鏚	qiJV
鐑	qiJW
锜	qiJX
簯	qiKQ
簱	qiKS
籏	qiKT
袳	qiKU
褀	qiKV
褄	qiKW
期	qiL
麒	qiLC
脐	qiLP
臍	qiLQ
竐	qiLS
竒	qiLT
肵	qiLU
麡	qiLV
骑	qiM
骐	qiMP
騎	qiMQ
盀	qiMS
盵	qiMT
粸	qiMU
闙	qiMV
騏	qiMW
騹	qiMX
妻	qiN
擒	qinA
揿	qinAP
扲	qinAQ
抋	qinAS
捦	qinAT
搇	qinAU
撳	qinAV
寝	qinB
寢	qinBQ
寑	qinBS
寖	qinBT
寴	qinBU
瘽	qinBV
螓	qinC
蚙	qinCQ
螼	qinCS
蠄	qinCT
沁	qinE
溱	qinEP
澿	qinEQ
瀙	qinES
綅	qinFQ
耹	qinFS
擎	qingA
掅	qingAQ
擏	qingAS
凊	qingBQ
寈	qingBS
轻	qingC
蜻	qingCP
輕	qingCQ
軽	qingCS
剠	qingDQ
殑	qingDS
清	qingE
淸	qingEQ
渹	qingES
漀	qingET
濪	qingEU
罄	qingF
綮	qingFP
綪	qingFQ
郬	qingFS
庆	qingG
庼	qingGQ
廎	qingGS
黥	qingH
檠	qingI
棾	qingIQ
樈	qingIS
檾	qingIT
櫦	qingIU
卿	qingJ
親	qingJQ
錆	qingJS
鑋	qingJT
勍	qingLQ
啨	qingOQ
磬	qingP
殸	qingPQ
硘	qingPS
碃	qingPT
青	qingQ
氰	qingQC
氢	qingQP
氫	qingQQ
庈	qinGQR
靑	qingQS
靘	qingQT
晴	qingR
暒	qingRQ
靲	qinGS
甠	qingSQ
埥	qingTQ
苘	qingU
葝	qingUQ
倾	qingV
傾	qingVQ
儬	qingVS
圊	qingW
情	qingX
慶	qingXQ
夝	qingXS
请	qingY
鲭	qingYC
謦	qingYD
顷	qingYP
請	qingYQ
頃	qingYS
鯖	qingYT
秦	qinH
虔	qinHR
檎	qinI
梫	qinIQ
钦	qinJ
锓	qinJC
矜	qinJP
斳	qinJQ
親	qinJS
鈙	qinJT
鈫	qinJU
鋟	qinJV
衾	qinK
笉	qinKQ
亲	qinL
勤	qinLP
肣	qinLQ
矝	qinMQ
駸	qinMS
骎	qinMT
媇	qinNQ
嫀	qinNS
鳹	qinNT
鵭	qinNU
噙	qinO
吣	qinOC
嗪	qinOP
吢	qinOQ
唚	qinOS
娸	qiNQ
欽	qinQQ
昑	qinRQ
婍	qiNS
嵚	qinSQ
嵰	qinSS
嶔	qinST
嶜	qinSU
鵸	qiNT
坅	qinTQ
埐	qinTS
鶀	qiNU
芹	qinUA
芩	qinUP
菣	qinUQ
菦	qinUS
菳	qinUT
藽	qinUU
侵	qinV
琴	qinW
珡	qinWQ
琹	qinWS
禽	qinX
覃	qinXP
忴	qinXQ
慬	qinXS
懃	qinXT
懄	qinXU
鶈	qiNY
誛	qinYQ
顉	qinYS
鮼	qinYT
赾	qinZQ
雂	qinZS
器	qiO
嘁	qiOC
啔	qiON
宆	qiongBQ
蛩	qiongC
蛬	qiongCQ
邛	qiongF
焪	qiongHQ
焭	qiongHS
煢	qiongHT
熍	qiongHU
桏	qiongIQ
橩	qiongIS
銎	qiongJ
卭	qiongJQ
筇	qiongK
笻	qiongKQ
睘	qiongMQ
瞏	qiongMS
嬛	qiongNQ
茕	qiongU
藑	qiongUQ
藭	qiongUS
儝	qiongVQ
琼	qiongW
瓊	qiongWQ
琁	qiongWS
璚	qiongWT
瓗	qiongWU
穷	qiongX
穹	qiongXP
窮	qiongXQ
惸	qiongXS
憌	qiongXT
竆	qiongXU
跫	qiongZ
舼	qiongZQ
赹	qiongZS
啓	qiOO
启	qiOP
啟	qiOQ
噐	qiOS
喰	qiOT
呇	qiOU
呚	qiOV
呮	qiOW
咠	qiOX
唘	qiOY
唭	qiOZ
砌	qiP
碛	qiPP
矵	qiPQ
碁	qiPS
碕	qiPT
碶	qiPU
磜	qiPV
磧	qiPW
磩	qiPX
礘	qiPY
气	qiQ
欺	qiQC
齐	qiQP
氣	qiQQ
齊	qiQS
欫	qiQT
気	qiQU
猉	qiQV
玂	qiQW
耆	qiR
晵	qiRQ
暣	qiRS
霋	qiRT
岂	qiS
崎	qiSC
祺	qiSD
岐	qiSE
祁	qiSF
屺	qiSG
祈	qiSP
岓	qiSQ
嵜	qiSS
祇	qiST
禥	qiSU
﨑	qiSV
畦	qiT
圻	qiTP
埼	qiTQ
墄	qiTS
畁	qiTT
葺	qiU
扏	qiuAQ
搝	qiuAS
赇	qiuB
鼽	qiuBP
賕	qiuBQ
萋	qiUC
蚯	qiuCA
蝤	qiuCC
虬	qiuCP
虯	qiuCQ
蛷	qiuCS
蝵	qiuCT
蟗	qiuCU
蠤	qiuCV
蕲	qiUD
殏	qiuDQ
求	qiuE
湫	qiuEC
泅	qiuEP
汓	qiuEQ
浗	qiuES
渞	qiuET
湬	qiuEU
湭	qiuEV
芑	qiUF
邱	qiuFA
紌	qiuFQ
絿	qiuFS
緧	qiuFT
巯	qiuG
龜	qiuGQ
鞦	qiuGS
鞧	qiuGT
龝	qiuGU
秋	qiuH
丠	qiuHQ
煪	qiuHS
秌	qiuHT
穐	qiuHU
楸	qiuI
朹	qiuIQ
梂	qiuIS
橚	qiuIT
萁	qiUJ
觓	qiuJQ
觩	qiuJS
釚	qiuJT
釻	qiuJU
銶	qiuJV
裘	qiuK
篍	qiuKQ
巰	qiuLQ
肍	qiuLS
糗	qiuM
毬	qiuMQ
盚	qiuMS
媝	qiuNQ
牫	qiuNS
鶖	qiuNT
鹙	qiuNU
叴	qiuOQ
唒	qiuOS
芪	qiUP
丘	qiuPA
皳	qiuPQ
芞	qiUQ
酋	qiuQA
犰	qiuQP
醔	qiuQQ
萕	qiUS
厹	qiuSQ
崷	qiuSS
薺	qiUT
坵	qiuTQ
塸	qiuTS
藄	qiUU
芁	qiuUQ
莍	qiuUS
萩	qiuUT
蓲	qiuUU
蘒	qiuUV
藒	qiUV
俅	qiuVA
球	qiuW
囚	qiuWP
玌	qiuWQ
璆	qiuWS
蘄	qiUX
恘	qiuXQ
恷	qiuXS
鳅	qiuY
鰌	qiuYO
鰽	qiuYQ
鰍	qiuYS
訄	qiuYT
訅	qiuYU
讎	qiuYV
讐	qiuYW
頄	qiuYX
鮂	qiuYY
鯄	qiuYZ
遒	qiuZ
逑	qiuZP
趥	qiuZQ
逎	qiuZS
企	qiV
俟	qiVC
乞	qiVP
倛	qiVQ
傶	qiVS
僛	qiVT
琦	qiW
琪	qiWP
敧	qiWQ
斉	qiWS
斊	qiWT
玘	qiWU
璂	qiWV
甈	qiWW
憩	qiX
慼	qiXN
愭	qiXO
懠	qiXQ
憇	qiXS
慽	qiXT
夡	qiXU
忔	qiXV
忯	qiXW
恓	qiXX
悽	qiXY
愒	qiXZ
鳍	qiY
讫	qiYC
颀	qiYP
鰭	qiYQ
訖	qiYS
諬	qiYT
頎	qiYU
鯕	qiYV
鲯	qiYW
起	qiZ
迄	qiZC
歧	qiZP
攲	qiZQ
艩	qiZS
趞	qiZT
跂	qiZU
踦	qiZV
迉	qiZW
拳	quanA
捲	quanAQ
搼	quanAS
痊	quanB
鬈	quanBP
辁	quanC
蜷	quanCP
蠸	quanCQ
輇	quanCS
齤	quanCT
券	quanD
奍	quanDQ
泉	quanE
洤	quanEQ
湶	quanES
灥	quanET
绻	quanF
絟	quanFQ
綣	quanFS
縓	quanFT
弮	quanGQ
烇	quanHQ
权	quanI
權	quanIQ
棬	quanIS
椦	quanIT
槫	quanIU
権	quanIV
楾	quanIW
铨	quanJ
觠	quanJQ
銓	quanJS
鐉	quanJT
筌	quanK
箞	quanKQ
劝	quanL
勸	quanLQ
勧	quanLS
矔	quanMQ
闎	quanMS
駩	quanMT
騡	quanMU
姾	quanNQ
婘	quanNS
孉	quanNT
牶	quanNU
牷	quanNV
犈	quanNW
啳	quanOQ
硂	quanPQ
犬	quanQ
犭	quanQC
醛	quanQP
狋	quanQQ
峑	quanSQ
巏	quanSS
畎	quanT
埢	quanTQ
荃	quanU
葲	quanUQ
虇	quanUS
全	quanV
佺	quanVQ
圈	quanW
圏	quanWQ
瑔	quanWS
韏	quanWT
悛	quanX
恮	quanXQ
惓	quanXS
颧	quanY
诠	quanYP
犮	quanYQ
詮	quanYS
顴	quanYT
鰁	quanYU
鳈	quanYV
跧	quanZQ
踡	quanZS
抾	quAQ
癯	quB
髷	quBQ
蛐	quC
蛆	quCC
龋	quCD
蠼	quCE
衢	quCP
忂	quCQ
蚼	quCS
蝺	quCT
螶	quCU
蟝	quCV
蠷	quCW
軥	quCX
齲	quCY
刞	quDQ
渠	quE
搉	queAQ
瘸	queB
蚗	queCQ
汋	queEQ
缺	queF
缼	queFQ
炔	queH
燩	queHQ
榷	queI
棤	queIQ
却	queJ
卻	queJQ
阙	queM
阕	queMP
闋	queMQ
闕	queMS
鹊	queN
鵲	queNQ
确	queP
確	quePQ
皵	quePS
硞	quePT
碏	quePU
碻	quePV
礐	quePW
礭	quePX
浀	quEQ
淭	quES
崅	queSQ
灈	quET
埆	queTQ
塙	queTS
墧	queTT
蒛	queUQ
傕	queVQ
敠	queWQ
敪	queWS
琷	queWT
悫	queX
愨	queXQ
慤	queXS
雀	queZ
趞	queZQ
区	quF
區	quFQ
匤	quFS
紶	quFT
絇	quFU
阹	quFV
戵	quGQ
黢	quH
焌	quHQ
煀	quHS
爠	quHT
欋	quIQ
欔	quIS
觑	quJ
斪	quJQ
覰	quJS
覷	quJT
覻	quJU
鑺	quJV
筁	quKQ
籧	quKS
袪	quKT
劬	quL
朐	quLP
竘	quLQ
竬	quLS
耝	quLT
胊	quLU
胠	quLV
臞	quLW
驱	quM
麴	quMC
氍	quMD
麯	quMO
阒	quMP
驅	quMQ
鼁	quMS
麹	quMT
粬	quMU
閴	quMV
闃	quMW
駆	quMX
駈	quMY
麮	quMZ
娶	quN
宭	qunBQ
帬	qunJQ
裙	qunK
箘	qunKQ
裠	qunKS
麇	qunL
麕	qunLQ
鸲	quNP
鴝	quNQ
歏	qunQQ
鶌	quNS
峮	qunSQ
鸜	quNT
囷	qunWQ
群	qunY
羣	qunYQ
逡	qunZ
夋	qunZQ
踆	qunZS
呿	quOQ
屈	quP
磲	quPP
欪	quQQ
曲	quR
去	quS
岖	quSC
祛	quSD
躯	quSP
嶇	quSQ
軀	quSS
厺	quST
岴	quSU
鼩	quSV
唟	quSW
坥	quTQ
苣	quU
蘧	quUC
蕖	quUP
菃	quUQ
葋	quUS
佢	quVQ
佉	quVS
伹	quVT
璩	quW
敺	quWQ
璖	quWS
憈	quXQ
衐	quXS
取	quY
诎	quYP
翑	quYQ
翵	quYS
詓	quYT
詘	quYU
誳	quYV
魼	quYW
鰸	quYX
鱋	quYY
趣	quZ
瞿	quZC
趋	quZP
趨	quZQ
趍	quZS
躣	quZT
迲	quZU
髯	ranB
髥	ranBQ
蚺	ranC
蚦	ranCQ
繎	ranFQ
攘	rangA
鬤	rangBQ
瀼	rangEQ
纕	rangFQ
瓤	rangG
穰	rangH
爙	rangHQ
穣	rangHS
勷	rangLQ
嚷	rangO
獽	rangQQ
禳	rangS
壤	rangT
壌	rangTQ
蘘	rangUQ
儴	rangVQ
懹	rangXQ
让	rangY
讓	rangYQ
譲	rangYS
躟	rangZQ
然	ranH
燃	ranHP
熯	ranHQ
染	ranI
橪	ranIQ
衻	ranKQ
袇	ranKS
袡	ranKT
肰	ranLQ
姌	ranNQ
媣	ranNS
呥	ranOQ
嘫	ranOS
冉	ranT
冄	ranTQ
苒	ranU
蒅	ranUQ
珃	ranWQ
扰	raoA
擾	raoAQ
绕	raoF
繞	raoFQ
隢	raoFS
穘	raoHQ
桡	raoI
橈	raoIQ
襓	raoKQ
娆	raoN
嬈	raoNQ
饶	raoS
饒	raoSQ
荛	raoU
蕘	raoUQ
遶	raoZQ
罖	raSQ
捼	reAQ
渃	reEQ
热	reH
熱	reHQ
扨	renAQ
轫	renC
軔	renCQ
刃	renD
刄	renDQ
纫	renF
紉	renFQ
紝	renFS
絍	renFT
纴	renFU
綛	renFV
扔	rengA
陾	rengFQ
靭	renGQ
靱	renGS
礽	rengSQ
芿	rengUQ
仍	rengV
辸	rengZQ
稔	renH
秂	renHQ
秹	renHS
朲	renIQ
杒	renIS
栠	renIT
栣	renIU
梕	renIV
棯	renIW
釰	renJQ
釼	renJS
鈓	renJT
銋	renJU
衽	renK
袵	renKQ
肕	renLQ
腍	renLS
妊	renN
姙	renNQ
牣	renNS
鵀	renNT
壬	renS
饪	renSP
屻	renSQ
祍	renSS
飪	renST
餁	renSU
躵	renSV
荏	renU
芢	renUQ
荵	renUS
菍	renUT
人	renV
仁	renVC
仞	renVD
任	renVP
仭	renVQ
亻	renVS
韧	renW
韌	renWQ
忍	renX
忈	renXQ
忎	renXS
认	renY
認	renYQ
訒	renYS
讱	renYT
魜	renYU
喏	reO
惹	reX
釰	riJQ
釼	riJS
鈤	riJT
衵	riKQ
馹	riMQ
驲	riMS
氜	riQQ
日	riR
囸	riWQ
搈	rongAQ
搑	rongAS
容	rongB
宂	rongBQ
融	rongC
蝾	rongCP
螎	rongCQ
蠑	rongCS
軵	rongCT
溶	rongE
瀜	rongEQ
绒	rongF
絨	rongFQ
縙	rongFS
戎	rongG
熔	rongH
烿	rongHQ
爃	rongHS
穁	rongHT
穃	rongHU
榕	rongI
榮	rongIQ
栄	rongIS
榵	rongIT
槦	rongIU
鎔	rongJQ
镕	rongJS
褣	rongKQ
肜	rongL
冗	rongM
毧	rongMQ
氄	rongMS
駥	rongMT
媶	rongNQ
嫆	rongNS
嬫	rongNT
狨	rongQ
曧	rongRQ
嵘	rongS
峵	rongSQ
嵤	rongSS
嶸	rongST
坈	rongTQ
荣	rongU
茸	rongUC
蓉	rongUP
茙	rongUQ
傇	rongVQ
傛	rongVS
瑢	rongWQ
羢	rongYQ
揉	rouA
宍	rouBQ
蝚	rouCQ
輮	rouCS
渘	rouEQ
鞣	rouG
煣	rouHQ
柔	rouI
楺	rouIQ
鍒	rouJQ
脜	rouLQ
腬	rouLS
糅	rouM
粈	rouMQ
騥	rouMS
媃	rouNQ
禸	rouNS
鶔	rouNT
肉	rouR
厹	rouSQ
葇	rouUQ
瑈	rouWQ
瓇	rouWS
韖	rouWT
譳	rouYQ
鰇	rouYS
蹂	rouZ
撋	ruanAQ
软	ruanC
軟	ruanCQ
輭	ruanCS
耎	ruanEQ
阮	ruanF
緛	ruanFQ
檽	ruanIQ
朊	ruanL
腝	ruanLQ
媆	ruanNQ
碝	ruanPQ
礝	ruanPS
堧	ruanTQ
壖	ruanTS
偄	ruanVQ
瑌	ruanWQ
瓀	ruanWS
挐	ruAQ
擩	ruAS
扖	ruAT
辱	ruC
蠕	ruCP
蝡	ruCQ
汝	ruE
溽	ruEC
洳	ruED
濡	ruEP
渪	ruEQ
缛	ruF
縟	ruFQ
繻	ruFS
邚	ruFT
鄏	ruFU
抐	ruiAQ
蚋	ruiC
蜹	ruiCQ
兊	ruiEQ
兌	ruiES
汭	ruiET
緌	ruiFQ
繠	ruiFS
枘	ruiI
桵	ruiIQ
橤	ruiIS
锐	ruiJ
銳	ruiJQ
鋭	ruiJS
鏸	ruiJT
笍	ruiKQ
睿	ruiM
杁	ruIQ
桇	ruIS
甤	ruiSQ
檽	ruIT
壡	ruiTQ
蕊	ruiU
蕤	ruiUC
芮	ruiUP
苼	ruiUQ
蕋	ruiUS
蘂	ruiUT
蘃	ruiUU
瑞	ruiW
惢	ruiXQ
叡	ruiYQ
铷	ruJ
帤	ruJQ
銣	ruJS
褥	ruK
襦	ruKP
筎	ruKQ
袽	ruKS
肗	ruLQ
如	ruN
润	runE
潤	runEQ
橍	runIQ
膶	runLQ
闰	runM
閏	runMQ
瞤	runMS
閠	runMT
媷	ruNQ
嬬	ruNS
鴑	ruNT
鴽	ruNU
鳰	ruNV
嚅	ruO
挼	ruoAQ
捼	ruoAS
渃	ruoEQ
鄀	ruoFQ
弱	ruoG
焫	ruoHQ
爇	ruoHS
楉	ruoIQ
箬	ruoK
篛	ruoKQ
婼	ruoNQ
鶸	ruoNS
吺	ruOQ
嗕	ruOS
嵶	ruoSQ
若	ruoU
蒻	ruoUQ
偌	ruoV
叒	ruoYQ
鰙	ruoYS
鰯	ruoYT
獳	ruQQ
醹	ruQS
入	ruR
曘	ruRQ
嶿	ruSQ
茹	ruU
蓐	ruUC
薷	ruUP
蒘	ruUQ
蕠	ruUS
乳	ruV
儒	ruVP
侞	ruVQ
颥	ruY
顬	ruYQ
鱬	ruYS
孺	ruZ
撒	saA
挲	saAP
挱	saAQ
摋	saAS
攃	saAT
洒	saE
灑	saEQ
泧	saES
潵	saET
飒	saF
纚	saFQ
隡	saFS
颯	saFT
靸	saGQ
鞈	saGS
卅	saH
揌	saiA
赛	saiB
賽	saiBQ
簺	saiKQ
腮	saiL
毢	saiMQ
毸	saiMS
噻	saiO
嗮	saiOQ
嘥	saiOS
櫒	saIQ
塞	saiT
僿	saiVQ
愢	saiXQ
鳃	saiY
顋	saiYQ
鰓	saiYS
鈒	saJQ
鏾	saJS
钑	saJT
脎	saL
馺	saMQ
鬖	sanBQ
潵	sanEQ
繖	sanFQ
搡	sangA
桑	sangI
桒	sangIQ
槡	sangIS
鎟	sangJQ
褬	sangKQ
嗓	sangO
喪	sangOQ
磉	sangP
丧	sangS
颡	sangY
顙	sangYQ
三	sanH
椮	sanIQ
厁	sanJQ
帴	sanJS
鏒	sanJT
鏾	sanJU
糁	sanM
毵	sanMP
毶	sanMQ
毿	sanMS
糂	sanMT
糝	sanMU
糣	sanMV
糤	sanMW
閐	sanMX
犙	sanNQ
叁	sanS
彡	sanSC
馓	sanSP
參	sanSQ
叄	sanSS
叅	sanST
壭	sanSU
饊	sanSV
伞	sanV
仨	sanVP
傘	sanVQ
仐	sanVS
俕	sanVT
散	sanW
弎	sanYQ
扫	saoA
搔	saoAP
掃	saoAQ
掻	saoAS
瘙	saoB
螦	saoCQ
溞	saoEQ
缫	saoF
繅	saoFQ
繰	saoFS
颾	saoFT
髞	saoGQ
臊	saoL
骚	saoM
騷	saoMQ
氉	saoMS
矂	saoMT
騒	saoMU
嫂	saoN
埽	saoT
慅	saoXQ
懆	saoXS
鳋	saoY
鰠	saoYQ
鱢	saoYS
萨	saU
薩	saUQ
蕯	saUS
訯	saYQ
躠	saZQ
拺	seAQ
摵	seAS
擌	seAT
瘷	seBQ
轖	seCQ
涩	seE
澀	seEQ
洓	seES
渋	seET
澁	seEU
濇	seEV
濏	seEW
瀒	seEX
繬	seFQ
飋	seFS
廧	seGQ
穑	seH
穡	seHQ
穯	seHS
栜	seIQ
铯	seJ
銫	seJQ
鎍	seJS
鏼	seJT
粣	seMQ
閪	seMS
闟	seMT
鬙	sengBQ
僧	sengV
森	senI
槮	senIS
襂	senKQ
嗇	seOQ
雭	seRQ
色	seS
啬	seSP
塞	seT
薔	seUQ
僿	seVQ
瑟	seW
琗	seWQ
璱	seWS
懎	seXQ
譅	seYQ
鱪	seYS
歮	seZQ
歰	seZS
挲	shaA
挱	shaAQ
摋	shaAS
痧	shaB
髿	shaBQ
厦	shaC
刹	shaD
剎	shaDQ
沙	shaE
濈	shaEQ
纱	shaF
紗	shaFQ
繺	shaFS
廈	shaGQ
煞	shaH
杀	shaI
摋	shaiAQ
攦	shaiAS
筛	shaiK
篩	shaiKQ
簁	shaiKS
簛	shaiKT
籭	shaiKU
酾	shaiQ
釃	shaiQQ
桬	shaIQR
晒	shaiR
曬	shaiRQ
榝	shaIS
樧	shaIT
諰	shaiYQ
铩	shaJ
帹	shaJQ
鎩	shaJS
裟	shaK
箑	shaKQ
粆	shaMQ
閯	shaMS
閷	shaMT
擅	shanA
挻	shanAQ
掞	shanAS
搧	shanAT
摻	shanAU
撣	shanAV
赡	shanB
疝	shanBP
贍	shanBQ
痁	shanBS
蟮	shanC
蟺	shanCQ
軕	shanCS
删	shanD
剡	shanDP
刪	shanDQ
剼	shanDS
汕	shanE
潸	shanEP
潬	shanEQ
澘	shanES
灗	shanET
陕	shanF
鄯	shanFC
缮	shanFP
陝	shanFQ
縿	shanFS
繕	shanFT
邖	shanFU
赏	shangB
賞	shangBQ
贘	shangBS
螪	shangCQ
殇	shangD
殤	shangDQ
泷	shangE
湯	shangEQ
滳	shangES
漡	shangET
绱	shangF
緔	shangFQ
鞝	shangGQ
鬺	shangGS
上	shangH
熵	shangHP
丄	shangHQ
扄	shangHS
樉	shangIQ
觞	shangJ
觴	shangJQ
鋿	shangJS
鏛	shangJT
鑜	shangJU
裳	shangK
商	shangO
晌	shangR
禓	shangSQ
墒	shangT
垧	shangTP
埫	shangTQ
蔏	shangUQ
伤	shangV
傷	shangVQ
尚	shangX
尙	shangXQ
恦	shangXS
愓	shangXT
慯	shangXU
謪	shangYQ
扇	shanH
煽	shanHP
炶	shanHQ
煔	shanHS
熌	shanHT
穇	shanHU
杉	shanI
栅	shanIP
柵	shanIQ
椫	shanIS
樿	shanIT
檆	shanIU
钐	shanJ
幓	shanJQ
覢	shanJS
釤	shanJT
銏	shanJU
鐥	shanJV
衫	shanK
笘	shanKQ
膳	shanL
膻	shanLP
脠	shanLQ
闪	shanM
骟	shanMP
閃	shanMQ
睒	shanMS
閄	shanMT
騸	shanMU
閊	shanMV
姗	shanN
嬗	shanNP
姍	shanNQ
善	shanO
單	shanOQ
嘇	shanOS
磰	shanPQ
歚	shanQQ
狦	shanQS
晱	shanRQ
山	shanS
嶦	shanSQ
禪	shanSS
饍	shanST
埏	shanT
圸	shanTQ
墠	shanTS
墡	shanTT
苫	shanU
芟	shanUP
傓	shanVQ
僐	shanVS
儃	shanVT
珊	shanW
敾	shanWQ
讪	shanY
鱔	shanYO
鳝	shanYP
鳣	shanYQ
鱣	shanYS
羴	shanYT
羶	shanYU
訕	shanYV
謆	shanYW
譱	shanYX
鯅	shanYY
鱓	shanYZ
跚	shanZ
舢	shanZP
赸	shanZQ
啥	shaO
捎	shaoA
勺	shaoB
髾	shaoBQ
蛸	shaoC
輎	shaoCQ
潲	shaoE
绍	shaoF
邵	shaoFP
紹	shaoFQ
旓	shaoFS
綤	shaoFT
鞘	shaoG
弰	shaoGQ
烧	shaoH
稍	shaoHP
燒	shaoHQ
焼	shaoHS
梢	shaoI
杓	shaoIP
柖	shaoIQ
卲	shaoJQ
筲	shaoK
袑	shaoKQ
劭	shaoL
睄	shaoMQ
娋	shaoNQ
哨	shaoO
唼	shaOP
唦	shaOQ
啑	shaOS
喢	shaOT
芍	shaoU
苕	shaoUP
莦	shaoUQ
萷	shaoUS
蕱	shaoUT
佋	shaoVQ
玿	shaoWQ
少	shaoX
韶	shaoY
鮹	shaoYQ
艄	shaoZ
砂	shaP
殺	shaPQ
硰	shaPS
歃	shaQ
猀	shaQQ
霎	shaR
莎	shaU
菨	shaUQ
萐	shaUS
蔱	shaUT
傻	shaV
倽	shaVQ
儍	shaVS
鲨	shaY
鯊	shaYQ
翜	shaYS
翣	shaYT
魦	shaYU
鯋	shaYV
乷	shaYW
歰	shaZQ
摄	sheA
揲	sheAP
挕	sheAQ
捨	sheAS
摂	sheAT
攝	sheAU
赊	sheB
賒	sheBQ
賖	sheBS
射	sheC
赦	sheCC
厍	sheCD
蛇	sheCP
厙	sheCQ
虵	sheCS
蛥	sheCT
蠂	sheCU
輋	sheCV
奢	sheD
奓	sheDQ
涉	sheE
滠	sheEP
泏	sheEQ
涻	sheES
渉	sheET
灄	sheEU
弽	sheGQ
檨	sheIQ
欇	sheIS
誰	sheiYQ
麝	sheL
闍	sheMQ
阇	sheMS
騇	sheMT
扟	shenAQ
抌	shenAS
搷	shenAT
审	shenB
審	shenBQ
瘆	shenBS
瘮	shenBT
蜃	shenC
蜄	shenCQ
深	shenE
渗	shenEC
渖	shenED
沈	shenEP
滲	shenEQ
兟	shenES
涁	shenET
淰	shenEU
瀋	shenEV
绅	shenF
紳	shenFQ
邥	shenFS
貹	shengBQ
賸	shengBS
﨡	shengCQ
剩	shengD
剰	shengDQ
斘	shengDS
殅	shengDT
渑	shengE
泩	shengEQ
渻	shengES
湦	shengET
澠	shengEU
绳	shengF
繩	shengFQ
聖	shengFS
聲	shengFT
縄	shengFU
繉	shengFV
阩	shengFW
陞	shengFX
陹	shengFY
焺	shengHQ
枡	shengIQ
椉	shengIS
榺	shengIT
橳	shengIU
栍	shengIV
鉎	shengJQ
鍟	shengJS
笙	shengK
胜	shengL
勝	shengLQ
竔	shengLS
省	shengM
眚	shengMC
盛	shengMP
牲	shengN
娍	shengNQ
鵿	shengNS
呏	shengOQ
升	shengP
乘	shengPP
乗	shengPQ
殸	shengPS
狌	shengQQ
弞	shenGQR
晟	shengR
昇	shengRQ
晠	shengRS
曻	shengRT
生	shengS
甥	shengSC
嵊	shengSD
声	shengSP
鼪	shengSQ
矤	shenGSR
圣	shengT
墭	shengTQ
苼	shengUQ
蕂	shengUS
偗	shengVQ
珄	shengWQ
琞	shengWS
憴	shengXQ
譝	shengYQ
甚	shenH
燊	shenHQ
黮	shenHS
椹	shenI
柛	shenIQ
棯	shenIS
榊	shenIT
罙	shenIU
幓	shenJQ
覾	shenJS
鉮	shenJT
鋠	shenJU
裑	shenKQ
肾	shenL
胂	shenLP
腎	shenLQ
脤	shenLS
糁	shenM
糝	shenMO
駪	shenMQ
糣	shenMS
冞	shenMT
眒	shenMU
眘	shenMV
瞫	shenMW
籶	shenMX
籸	shenMY
糂	shenMZ
婶	shenN
娠	shenNP
嬸	shenNQ
妽	shenNS
姺	shenNT
嫀	shenNU
鵢	shenNV
呻	shenO
哂	shenOP
砷	shenP
氠	shenQQ
昚	shenRQ
曋	shenRS
曑	shenRT
身	shenS
参	shenSC
矧	shenSD
神	shenSP
罧	shenSQ
參	shenSS
叄	shenST
叅	shenSU
屾	shenSV
峷	shenSW
甡	shenSX
甧	shenSY
祳	shenSZ
申	shenT
堔	shenTQ
莘	shenU
葚	shenUP
葠	shenUQ
蓡	shenUS
蔘	shenUT
薓	shenUU
什	shenV
伸	shenVP
侁	shenVQ
侺	shenVS
珅	shenWQ
敒	shenWS
慎	shenX
愼	shenXQ
穼	shenXS
诜	shenY
鰰	shenYL
魫	shenYM
頣	shenYN
谉	shenYO
谂	shenYP
鲹	shenYQ
鰺	shenYS
鯵	shenYT
鯓	shenYU
訠	shenYV
訷	shenYW
詵	shenYX
諗	shenYY
讅	shenYZ
磼	shePQ
猞	sheQ
歙	sheQP
社	sheS
舌	sheSC
舍	sheSP
舎	sheSQ
畲	sheT
畬	sheTQ
畭	sheTS
蔎	sheUQ
佘	sheV
韘	sheWQ
慑	sheX
慴	sheXQ
懾	sheXS
设	sheY
設	sheYQ
拾	shiA
拭	shiAP
揓	shiAQ
实	shiB
匙	shiBC
贳	shiBD
室	shiBP
實	shiBQ
実	shiBS
宩	shiBT
宲	shiBU
寔	shiBV
痑	shiBW
貰	shiBX
释	shiC
虱	shiCC
轼	shiCD
螫	shiCE
蚀	shiCP
蝕	shiCQ
釋	shiCS
厔	shiCT
徥	shiCU
蝨	shiCV
軾	shiCW
釈	shiCX
失	shiD
奭	shiDQ
湿	shiE
溼	shiEN
溮	shiEO
濕	shiEQ
澨	shiES
澤	shiET
亊	shiEU
兘	shiEV
浉	shiEW
湜	shiEX
湤	shiEY
溡	shiEZ
施	shiF
絁	shiFQ
邿	shiFS
事	shiH
炻	shiHC
世	shiHP
丗	shiHQ
戺	shiHS
烒	shiHT
煶	shiHU
秲	shiHV
丆	shiHW
柿	shiI
嘘	shiIP
枾	shiIQ
柹	shiIS
栻	shiIT
楴	shiIU
榯	shiIV
檡	shiiW
榁	shiIX
市	shiJ
视	shiJC
铈	shiJD
鉇	shiJM
鉃	shiJN
鉂	shiJO
师	shiJP
師	shiJQ
視	shiJS
鍦	shiJT
銴	shiJU
鉽	shiJV
鉐	shiJW
觢	shiJX
釶	shiJY
鈰	shiJZ
兙	shiKQ
筮	shiKR
笶	shiKS
箷	shiKT
簭	shiKU
籂	shiKV
褷	shiKW
襫	shiKX
襹	shiKY
势	shiL
勢	shiLQ
竍	shiLS
驶	shiM
駛	shiMQ
冟	shiMS
眂	shiMT
眎	shiMU
眡	shiMV
睗	shiMW
馶	shiMX
始	shiN
姼	shiNQ
嬕	shiNS
鳲	shiNT
鳾	shiNU
鶳	shiNV
鸤	shiNW
史	shiO
噬	shiOC
嗜	shiOP
呞	shiOQ
呩	shiOS
咶	shiOT
啫	shiOU
噓	shiOV
石	shiP
屎	shiPC
尸	shiPP
屍	shiPQ
碩	shiPS
乭	shiPT
狮	shiQ
獅	shiQQ
狧	shiQS
狶	shiQT
醳	shiQU
釃	shiQV
是	shiR
时	shiRP
時	shiRQ
旹	shiRS
昰	shiRT
十	shiS
士	shiSC
食	shiSD
氏	shiSE
饰	shiSF
矢	shiSG
舐	shiSJ
豕	shiSK
礻	shiSL
示	shiSP
飾	shiSQ
卋	shiSQR
峕	shiSS
餝	shiSSR
崻	shiST
鼫	shiSTR
崼	shiSU
鼭	shiSUR
嵵	shiSV
餙	shiSVR
祏	shiSW
飠	shiSWR
舓	shiSX
饣	shiSY
埘	shiT
埶	shiTQ
塒	shiTS
畤	shiTT
蓍	shiU
莳	shiUP
葹	shiUQ
蒒	shiUS
蒔	shiUT
使	shiV
侍	shiVC
仕	shiVD
什	shiVP
乨	shiVQ
佦	shiVS
瓧	shiWQ
瑡	shiWS
恃	shiX
忕	shiXQ
忯	shiXS
恀	shiXT
惿	shiXU
式	shiY
试	shiYC
诗	shiYD
誓	shiYE
谥	shiYF
弑	shiYG
鲥	shiYH
鲺	shiYI
鮖	shiYM
識	shiYN
謚	shiYO
识	shiYP
試	shiYQ
詩	shiYS
鰤	shiYT
鰣	shiYU
鰘	shiYV
鯴	shiYW
弒	shiYX
諟	shiYY
諡	shiYZ
适	shiZ
逝	shiZP
適	shiZQ
辻	shiZS
遈	shiZT
遾	shiZU
手	shouA
授	shouAP
扌	shouAQ
守	shouB
兽	shouBC
瘦	shouBP
痩	shouBQ
寿	shouC
涭	shouEQ
绶	shouF
綬	shouFQ
鏉	shouJQ
膄	shouLQ
售	shouO
嘼	shouOQ
狩	shouQ
獸	shouQQ
獣	shouQS
首	shouS
壽	shouSQ
夀	shouSS
垨	shouTQ
收	shouW
敊	shouWQ
受	shouY
収	shouYQ
艏	shouZ
抒	shuA
蜀	shuaC
刷	shuaD
耍	shuaE
摔	shuaiA
蟀	shuaiC
縗	shuaiFQ
缞	shuaiFS
帅	shuaiJ
帥	shuaiJQ
衰	shuaiK
卛	shuaiSQ
率	shuaiX
甩	shuaiY
拴	shuanA
涮	shuanE
絟	shuanFQ
爽	shuangD
漺	shuangEQ
瀧	shuangES
灀	shuangET
縔	shuangFQ
欆	shuangIQ
鏯	shuangJQ
騻	shuangMQ
驦	shuangMS
骦	shuangMT
孀	shuangN
孇	shuangNQ
鷞	shuangNS
鸘	shuangNT
鹴	shuangNU
礵	shuangPQ
霜	shuangR
塽	shuangTQ
慡	shuangXQ
双	shuangY
﨎	shuangYQ
艭	shuangZQ
雙	shuangZS
栓	shuanI
槫	shuanIQ
腨	shuanLQ
闩	shuanM
閂	shuanMQ
唰	shuaO
摅	shuAP
捈	shuAQ
捒	shuAS
掓	shuAT
攄	shuAU
誜	shuaYQ
赎	shuB
贖	shuBQ
癙	shuBS
输	shuC
蜀	shuCP
輸	shuCQ
尌	shuCS
蠴	shuCT
軗	shuCU
殊	shuD
豎	shuDQ
鼡	shuDS
淑	shuE
澍	shuEC
沭	shuED
漱	shuEP
潄	shuEQ
潻	shuES
濖	shuET
瀭	shuEU
纾	shuF
紓	shuFQ
絉	shuFS
綀	shuFT
緰	shuFU
鄃	shuFV
陎	shuFW
隃	shuFX
庶	shuG
戍	shuGP
庻	shuGQ
熟	shuH
秫	shuHC
黍	shuHP
焂	shuHQ
稌	shuHS
虪	shuHT
术	shuI
梳	shuIA
挩	shuiAQ
捝	shuiAS
束	shuIC
枢	shuID
水	shuiE
氺	shuiEQ
涗	shuiES
涚	shuiET
氵	shuiEU
税	shuiH
稅	shuiHQ
帨	shuiJQ
裞	shuiKQ
脽	shuiLQ
睡	shuiM
娷	shuiNQ
树	shuIP
樹	shuIQ
樞	shuIS
祱	shuiSQ
朮	shuIT
杸	shuIU
橾	shuIV
说	shuiY
谁	shuiYP
誰	shuiYQ
說	shuiYS
説	shuiYT
鉥	shuJQ
錰	shuJS
鏣	shuJT
籔	shuKQ
裋	shuKS
襡	shuKT
襩	shuKU
竖	shuL
丨	shuLC
腧	shuLP
竪	shuLQ
毹	shuM
毺	shuMQ
糬	shuMS
姝	shuN
鬊	shunBQ
楯	shunIQ
橓	shunIS
瞬	shunM
眴	shunMQ
瞚	shunMS
瞤	shunMT
吮	shunO
婌	shuNQ
鵨	shuNS
鶐	shuNT
蕣	shunUQ
顺	shunY
順	shunYQ
舜	shunZ
搠	shuoA
洬	shuoEQ
烁	shuoH
爍	shuoHQ
槊	shuoI
铄	shuoJ
銏	shuoJQ
鎙	shuoJS
鑠	shuoJT
箾	shuoKQ
朔	shuoL
矟	shuoMQ
妁	shuoN
硕	shuoP
碩	shuoPQ
咰	shuOQ
欶	shuoQQ
獡	shuoQS
蒴	shuoU
数	shuoW
數	shuoWQ
愬	shuoXQ
说	shuoY
說	shuoYQ
説	shuoYS
属	shuP
殳	shuPP
屬	shuPQ
暑	shuR
曙	shuRP
書	shuRQ
兪	shuRS
暏	shuRT
霔	shuRU
舒	shuS
署	shuSC
鼠	shuSP
塾	shuT
墅	shuTP
蔬	shuU
菽	shuUC
薯	shuUP
荗	shuUQ
蒁	shuUS
蒣	shuUT
薥	shuUU
藷	shuUV
书	shuV
俞	shuVC
倏	shuVD
疏	shuVP
侸	shuVQ
倐	shuVS
儵	shuVT
数	shuW
數	shuWQ
琡	shuWS
瑹	shuWT
璹	shuWU
恕	shuX
尗	shuXQ
忬	shuXS
怷	shuXT
怸	shuXU
悆	shuXV
術	shuXW
叔	shuY
鮛	shuYQ
鱰	shuYS
述	shuZ
孰	shuZP
疎	shuZQ
跾	shuZS
踈	shuZT
撕	siA
凘	siBQ
寺	siC
蛳	siCC
厮	siCP
厠	siCQ
蜤	siCS
螄	siCT
蟖	siCU
蟴	siCV
死	siD
泗	siE
澌	siEC
兕	siED
汜	siEP
亖	siEQ
泀	siES
泤	siET
洍	siEU
洠	siEV
涘	siEW
瀃	siEX
缌	siF
絲	siFQ
糹	siFS
緦	siFT
纟	siFU
颸	siFV
飔	siFW
糸	siFX
廝	siGQ
丝	siH
私	siHP
燍	siHQ
虒	siHS
杫	siIQ
枱	siIS
柶	siIT
梩	siIU
楒	siIV
榹	siIW
斯	siJ
銯	siJO
锶	siJP
鐁	siJQ
覗	siJS
釲	siJT
鈶	siJU
鈻	siJV
鉰	siJW
銉	siJX
鋖	siJY
鍶	siJZ
笥	siK
簛	siKQ
耜	siL
竢	siLQ
耛	siLS
驷	siM
駟	siMQ
騃	siMS
騦	siMT
鸶	siN
姒	siNP
娰	siNQ
媤	siNS
牭	siNT
鷥	siNU
司	siO
嗣	siOC
咝	siOD
嘶	siOP
噝	siOQ
磃	siPQ
食	siS
祀	siSC
巳	siSD
厶	siSE
饲	siSP
飼	siSQ
禗	siSS
禠	siST
禩	siSU
罳	siSV
飤	siSW
飴	siSX
鼶	siSY
蕬	siUQ
蕼	siUS
似	siV
俟	siVC
伺	siVP
佀	siVQ
価	siVS
俬	siVT
偲	siVU
傂	siVV
儩	siVW
四	siW
思	siX
恖	siXQ
愢	siXS
厼	siXT
肆	siY
肂	siYQ
鯣	siYS
孠	siZQ
貄	siZS
捒	songAQ
揔	songAS
摗	songAT
宋	songB
凇	songBP
鬆	songBQ
淞	songE
漎	songEQ
濍	songES
耸	songF
聳	songFQ
庺	songGQ
松	songI
枀	songIQ
枩	songIS
柗	songIT
梥	songIU
棇	songIV
楤	songIW
檧	songIX
鎹	songJQ
竦	songL
駷	songMQ
娀	songNQ
吅	songOQ
硹	songPQ
嵩	songS
崧	songSP
嵷	songSQ
餸	songSS
菘	songU
倯	songVQ
傱	songVS
悚	songX
忪	songXC
怂	songXP
愡	songXQ
愯	songXS
慫	songXT
憽	songXU
颂	songY
诵	songYC
讼	songYP
訟	songYQ
誦	songYS
頌	songYT
送	songZ
搜	souA
擞	souAP
捒	souAQ
捜	souAS
摉	souAT
摗	souAU
撨	souAV
擻	souAW
凁	souBQ
瘶	souBS
螋	souC
溲	souE
飕	souF
鄋	souFQ
颼	souFS
颾	souFT
廀	souGQ
廋	souGS
棷	souIQ
櫢	souIS
锼	souJ
鎪	souJQ
鏉	souJS
籔	souKQ
瞍	souM
騪	souMQ
嗽	souO
嗾	souOC
嗖	souOP
欶	souQQ
獀	souQS
醙	souQT
馊	souS
餿	souSQ
薮	souU
蒐	souUQ
蓃	souUS
藪	souUT
傁	souVQ
叟	souY
叜	souYQ
艘	souZ
痠	suanBQ
匴	suanFQ
算	suanK
笇	suanKQ
筭	suanKS
篹	suanKT
酸	suanQ
狻	suanQP
祘	suanSQ
蒜	suanU
摵	suAQ
宿	suB
殐	suDQ
溯	suE
涑	suEP
泝	suEQ
洬	suES
溸	suET
潚	suEU
潥	suEV
素	suF
缩	suFP
縮	suFQ
縤	suFS
稡	suHQ
穌	suHS
賥	suiBQ
虽	suiC
濉	suiE
亗	suiEQ
浽	suiES
滖	suiET
澻	suiEU
瀡	suiEV
随	suiF
绥	suiFC
隧	suiFD
隋	suiFP
隨	suiFQ
旞	suiFS
綏	suiFT
縗	suiFU
繀	suiFV
繐	suiFW
繸	suiFX
缞	suiFY
髓	suiG
鞖	suiGQ
髄	suiGS
穗	suiH
燧	suiHP
煫	suiHQ
熣	suiHS
穂	suiHT
穟	suiHU
檖	suiIQ
鏸	suiJQ
鐆	suiJS
鐩	suiJT
襚	suiKQ
膸	suiLQ
睢	suiM
眭	suiMP
毸	suiMQ
睟	suiMS
娞	suiNQ
嬘	suiNS
棴	suIO
哸	suiOQ
嗺	suiOS
碎	suiP
砕	suiPQ
梀	suIQ
岁	suiS
祟	suiSP
嵗	suiSQ
禭	suiSS
榡	suIT
埣	suiTQ
樎	suIU
芕	suiUQ
荽	suiUR
荾	suiUS
樕	suIV
倠	suiVQ
橚	suIW
璲	suiWQ
瓍	suiWS
韢	suiWT
櫯	suIX
谇	suiY
誶	suiYQ
譢	suiYS
遂	suiZ
邃	suiZP
歲	suiZQ
雖	suiZS
夊	suiZT
歳	suiZU
遀	suiZV
夙	suJ
觫	suJP
鋉	suJQ
簌	suK
膆	suLQ
粟	suM
粛	suMQ
驌	suMS
骕	suMT
损	sunA
損	sunAQ
扻	sunAS
搎	sunAT
摌	sunAU
潠	sunEQ
榫	sunI
槂	sunIQ
鎨	sunJQ
笋	sunK
筍	sunKQ
箰	sunKS
簨	sunKT
鶽	sunNQ
喰	sunOQ
嫊	suNQ
猻	sunQQ
狲	sunQR
鷫	suNS
飱	sunSQ
鹔	suNT
荪	sunU
蓀	sunUQ
蕵	sunUS
薞	sunUT
飧	sunX
孙	sunZ
隼	sunZP
孫	sunZQ
嗉	suO
挲	suoA
挱	suoAQ
摍	suoAS
蜶	suoCQ
溑	suoEQ
溹	suoES
索	suoF
缩	suoFP
縒	suoFQ
縮	suoFS
所	suoH
梭	suoI
桫	suoIP
锁	suoJ
鎖	suoJQ
鎍	suoJS
鎻	suoJT
鏁	suoJU
簑	suoKQ
簔	suoKS
褨	suoKT
睃	suoM
娑	suoN
嫅	suoNQ
嗦	suoO
唢	suoOC
嗍	suoOD
唆	suoOP
嗩	suoOQ
囌	suOQ
獕	suoQQ
暛	suoRQ
莎	suoU
蓑	suoUP
莏	suoUQ
傞	suoVQ
琐	suoW
瑣	suoWQ
琑	suoWS
璅	suoWT
惢	suoXQ
羧	suoY
鮻	suoYQ
乺	suoYS
趖	suoZQ
逤	suoZS
碿	suPQ
酥	suQ
缩	suS
甦	suSQ
餗	suSS
塑	suT
圱	suTQ
埣	suTS
塐	suTT
苏	suU
蔌	suUP
蘇	suUQ
莤	suUS
藗	suUT
蘓	suUU
俗	suV
僳	suVP
傃	suVQ
玊	suWQ
珟	suWS
璛	suWT
愫	suX
愬	suXQ
憟	suXS
窣	suXT
诉	suY
稣	suYC
谡	suYD
肃	suYP
肅	suYQ
訴	suYS
謖	suYT
鯂	suYU
鱐	suYV
速	suZ
趚	suZQ
蹜	suZS
遡	suZT
遬	suZU
挞	taA
搨	taAQ
撻	taAS
它	taB
沓	taE
溻	taEC
漯	taEP
涾	taEQ
溚	taES
澾	taET
濌	taEU
鞈	taGQ
鞜	taGS
鞳	taGT
榻	taI
抬	taiA
擡	taiAQ
冭	taiBQ
大	taiD
太	taiDP
夳	taiDQ
奤	taiDS
泰	taiE
汰	taiEP
汏	taiEQ
汱	taiES
溙	taiET
邰	taiF
颱	taiFQ
炱	taiH
炲	taiHQ
燤	taiHS
枱	taiIQ
檯	taiIS
钛	taiJ
鈦	taiJQ
箈	taiKQ
籉	taiKS
胎	taiL
肽	taiLP
骀	taiM
駘	taiMQ
嬯	taiNQ
台	taiO
榙	taIQ
酞	taiQR
旲	taiRQ
橽	taIS
坮	taiTQ
苔	taiU
薹	taiUP
菭	taiUQ
儓	taiVQ
囼	taiWQ
斄	taiWS
珆	taiWT
态	taiX
態	taiXQ
忕	taiXS
忲	taiXT
鲐	taiY
鮐	taiYQ
跆	taiZ
孡	taiZQ
臺	taiZS
舦	taiZT
铊	taJ
鉈	taJQ
錔	taJS
鎉	taJT
鎑	taJU
褟	taKQ
襨	taKS
闼	taM
毾	taMQ
粏	taMS
闒	taMT
闟	taMU
闥	taMV
阘	taMW
她	taN
探	tanA
摊	tanAP
攤	tanAQ
擹	tanAS
贪	tanB
瘫	tanBC
痰	tanBP
癱	tanBQ
貪	tanBS
痑	tanBT
滩	tanE
澹	tanEC
潭	tanEP
灘	tanEQ
湠	tanES
潬	tanET
郯	tanF
緂	tanFQ
繵	tanFS
罈	tanFT
罎	tanFU
弹	tanG
搪	tangA
摥	tangAQ
螳	tangC
螗	tangCP
蝪	tangCQ
赯	tangCS
劏	tangDQ
汤	tangE
溏	tangEC
淌	tangEP
湯	tangEQ
漟	tangES
灙	tangET
鄌	tangFQ
隚	tangFS
唐	tangG
鞺	tangGQ
鼞	tangGS
烫	tangH
燙	tangHQ
煻	tangHS
爣	tangHT
棠	tangI
樘	tangIP
榶	tangIQ
橖	tangIS
帑	tangJ
镗	tangJC
铴	tangJP
鎕	tangJQ
鎲	tangJS
鏜	tangJT
鐋	tangJU
钂	tangJV
镋	tangJW
篖	tangKQ
膛	tangL
耥	tangLP
膅	tangLQ
糖	tangM
矘	tangMQ
糃	tangMS
糛	tangMT
闛	tangMU
鶶	tangNQ
啺	tangOQ
嘡	tangOS
磄	tangPQ
彈	tanGQ
醣	tangQR
曭	tangRQ
躺	tangS
嵣	tangSQ
弾	tanGSR
禟	tangSS
餹	tangST
饄	tangSU
堂	tangT
塘	tangTP
坣	tangTQ
蓎	tangUQ
薚	tangUS
倘	tangV
傥	tangVP
伖	tangVQ
偒	tangVS
傏	tangVT
儻	tangVU
瑭	tangW
惝	tangX
愓	tangXQ
戃	tangXS
羰	tangY
趟	tangZ
踼	tangZQ
蹚	tangZS
炭	tanH
燂	tanHQ
檀	tanI
榃	tanIQ
橝	tanIS
钽	tanJ
锬	tanJP
鉭	tanJQ
錟	tanJS
袒	tanK
襢	tanKQ
毯	tanM
婒	tanNQ
叹	tanO
嘆	tanOQ
啴	tanOS
嗿	tanOT
嘽	tanOU
嘾	tanOV
碳	tanP
牠	taNQ
歎	tanQQ
醈	tanQS
醓	tanQT
醰	tanQU
昙	tanR
暺	tanRQ
曇	tanRS
舑	tanSQ
舕	tanSS
坦	tanT
坍	tanTC
坛	tanTP
壇	tanTQ
埮	tanTS
墰	tanTT
墵	tanTU
壜	tanTV
菼	tanUQ
藫	tanUS
倓	tanVQ
傝	tanVS
僋	tanVT
儃	tanVU
璮	tanWQ
覃	tanX
忐	tanXP
怹	tanXQ
惔	tanXS
憛	tanXT
憳	tanXU
憻	tanXV
谈	tanY
谭	tanYP
談	tanYQ
譚	tanYS
譠	tanYT
顃	tanYU
貚	tanZQ
嗒	taO
掏	taoA
抭	taoAQ
搯	taoAS
匋	taoBQ
蜪	taoCQ
轁	taoCS
套	taoD
夲	taoDQ
夵	taoDS
涛	taoE
滔	taoEC
洮	taoED
淘	taoEP
濤	taoEQ
涭	taoES
陶	taoF
绦	taoFP
絛	taoFQ
綯	taoFS
縚	taoFT
縧	taoFU
绹	taoFV
弢	taoGQ
鞀	taoGS
鞉	taoGT
鞱	taoGU
燾	taoHQ
桃	taoI
梼	taoIQ
槄	taoIS
檮	taoIT
幍	taoJQ
鋾	taoJS
裪	taoKQ
駣	taoMQ
騊	taoMS
嫍	taoNQ
叨	taoO
啕	taoOP
咷	taoOQ
鼗	taoP
嚃	taOQ
醄	taoQQ
嚺	taOS
祹	taoSQ
饕	taoSR
飸	taoSS
饀	taoST
萄	taoU
韬	taoW
瑫	taoWQ
韜	taoWS
慆	taoXQ
讨	taoY
討	taoYQ
詜	taoYS
謟	taoYT
逃	taoZ
迯	taoZQ
獭	taQ
狧	taQQ
獺	taQS
祂	taSQ
崉	taSS
禢	taST
塔	taT
塌	taTP
墖	taTQ
他	taV
侤	taVQ
傝	taVS
鳎	taY
誻	taYQ
譶	taYS
鮙	taYT
鰨	taYU
踏	taZ
趿	taZC
遢	taZD
蹋	taZP
蹹	taZQ
躢	taZS
遝	taZT
貸	teBQ
蟘	teCQ
铽	teJ
鋱	teJQ
脦	teLQ
特	teN
疼	tengB
痋	tengBQ
螣	tengCQ
漛	tengEQ
縢	tengFQ
鼟	tengGQ
熥	tengHQ
幐	tengJQ
籐	tengKQ
籘	tengKS
腾	tengL
滕	tengLP
膯	tengLQ
騰	tengMQ
駦	tengMS
驣	tengMT
霯	tengRQ
藤	tengU
虅	tengUQ
儯	tengVQ
誊	tengY
謄	tengYQ
鰧	tengYS
邆	tengZQ
犆	teNQ
忑	teX
慝	teXP
忒	teY
提	tiA
掭	tianA
搷	tianAQ
兲	tianBQ
痶	tianBS
賟	tianBT
天	tianD
殄	tianDP
添	tianE
沺	tianEQ
淟	tianES
湉	tianET
紾	tianFQ
緂	tianFS
甜	tianG
甛	tianGQ
黇	tianHQ
覥	tianJQ
觍	tianJS
鈿	tianJT
銛	tianJU
銽	tianJV
錪	tianJW
铦	tianJX
腆	tianL
胋	tianLQ
阗	tianM
盷	tianMQ
睓	tianMS
闐	tianMT
奵	tianNQ
婖	tianNS
鴫	tianNT
鷆	tianNU
鷏	tianNV
呑	tianOQ
唺	tianOS
屇	tianPQ
碵	tianPS
磌	tianPT
酟	tianQQ
靔	tianQS
靝	tianQT
晪	tianRQ
舔	tianS
舚	tianSQ
餂	tianSS
田	tianT
畋	tianTC
填	tianTP
塡	tianTQ
畑	tianTS
畠	tianTT
菾	tianUQ
倎	tianVQ
琠	tianWQ
瑱	tianWS
璳	tianWT
恬	tianX
忝	tianXP
悿	tianXQ
窴	tianXS
挑	tiaoA
髫	tiaoB
宨	tiaoBQ
龆	tiaoC
蜩	tiaoCP
齠	tiaoCQ
斢	tiaoDQ
絩	tiaoFQ
聎	tiaoFS
庣	tiaoGQ
鞗	tiaoGS
条	tiaoI
條	tiaoIQ
朷	tiaoIS
樤	tiaoIT
覜	tiaoJQ
銚	tiaoJS
鋚	tiaoJT
鎥	tiaoJU
笤	tiaoK
朓	tiaoLQ
脁	tiaoLS
眺	tiaoM
粜	tiaoMP
糶	tiaoMQ
嬥	tiaoNQ
旫	tiaoRQ
晀	tiaoRS
祧	tiaoS
岧	tiaoSQ
岹	tiaoSS
祒	tiaoST
苕	tiaoU
芀	tiaoUQ
萔	tiaoUS
蓚	tiaoUT
蓧	tiaoUU
蓨	tiaoUV
佻	tiaoV
窕	tiaoX
恌	tiaoXQ
窱	tiaoXS
调	tiaoY
鲦	tiaoYP
誂	tiaoYQ
調	tiaoYS
鯈	tiaoYT
鰷	tiaoYU
跳	tiaoZ
迢	tiaoZP
趒	tiaoZQ
挮	tiAQ
掦	tiAS
揥	tiAT
擿	tiAU
髰	tiBQ
鬀	tiBS
鬄	tiBT
厗	tiCQ
徥	tiCS
徲	tiCT
剔	tiD
剃	tiDP
奃	tiDQ
殢	tiDS
涕	tiE
贴	tieB
貼	tieBQ
蛈	tieCQ
聑	tieFQ
铁	tieJ
帖	tieJP
鐵	tieJQ
鉄	tieJS
銕	tieJT
鐡	tieJU
驖	tieMQ
呫	tieOQ
洟	tiEQ
渧	tiES
飻	tieSQ
餮	tieSR
漽	tiET
萜	tieU
僣	tieVQ
怗	tieXQ
跕	tieZQ
绨	tiF
缇	tiFP
綈	tiFQ
緹	tiFS
體	tiGQ
骵	tiGS
戻	tiHQ
稊	tiHS
梯	tiI
桋	tiIQ
锑	tiJ
銻	tiJQ
鍗	tiJS
裼	tiK
笹	tiKQ
籊	tiKS
褅	tiKT
褆	tiKU
眣	tiMQ
睼	tiMS
騠	tiMT
鹈	tiN
挺	tingA
厅	tingC
蜓	tingCP
厛	tingCQ
蝏	tingCS
汀	tingE
涏	tingEQ
渟	tingES
濎	tingET
聽	tingFQ
綎	tingFS
聤	tingFT
聴	tingFU
聼	tingFV
邒	tingFW
庭	tingG
廳	tingGQ
庁	tingGS
庍	tingGT
廰	tingGU
鞓	tingGV
烃	tingH
烴	tingHQ
烶	tingHS
梃	tingI
桯	tingIQ
楟	tingIS
榳	tingIT
铤	tingJ
鋌	tingJQ
筳	tingKQ
耓	tingLQ
脡	tingLS
閮	tingMQ
婷	tingN
娗	tingNQ
听	tingO
霆	tingR
嵉	tingSQ
鼮	tingSS
亭	tingT
圢	tingTQ
甼	tingTS
葶	tingU
莛	tingUP
停	tingV
侱	tingVQ
侹	tingVS
珽	tingWQ
忊	tingXQ
廷	tingYP
誔	tingYQ
諪	tingYS
頲	tingYT
颋	tingYU
艇	tingZ
媂	tiNQ
媞	tiNS
鵜	tiNT
鶗	tiNU
鶙	tiNV
鷈	tiNW
鷉	tiNX
鷤	tiNY
啼	tiO
嚏	tiOP
啑	tiOQ
嗁	tiOS
嚔	tiOT
屉	tiP
屜	tiPQ
屟	tiPS
碮	tiPT
磃	tiPU
醍	tiQ
歒	tiQQ
替	tiR
崹	tiSQ
禔	tiSS
禵	tiST
罤	tiSU
躰	tiSV
軆	tiSW
荑	tiU
苐	tiUQ
蕛	tiUS
薙	tiUT
体	tiV
倜	tiVP
俶	tiVQ
偍	tiVS
珶	tiWQ
瑅	tiWS
瓋	tiWT
惕	tiX
悌	tiXP
悐	tiXQ
惖	tiXS
惿	tiXT
题	tiY
題	tiYQ
謕	tiYS
鮷	tiYT
鯷	tiYU
鳀	tiYV
踢	tiZ
逖	tiZC
蹄	tiZP
趧	tiZQ
趯	tiZS
蹏	tiZT
逷	tiZU
遆	tiZV
捅	tongA
痛	tongB
痌	tongBQ
蚒	tongCQ
赨	tongCS
潼	tongE
浵	tongEQ
统	tongF
統	tongFQ
絧	tongFS
綂	tongFT
庝	tongGQ
炵	tongHQ
烔	tongHS
熥	tongHT
燑	tongHU
秱	tongHV
穜	tongHW
桶	tongI
桐	tongIP
樋	tongIQ
橦	tongIS
铜	tongJ
銅	tongJQ
鉖	tongJS
鉵	tongJT
筒	tongK
筩	tongKQ
童	tongL
勭	tongLQ
朣	tongLS
膧	tongLT
瞳	tongM
氃	tongMQ
眮	tongMS
粡	tongMT
犝	tongNQ
同	tongO
嗵	tongOP
哃	tongOQ
砼	tongP
硧	tongPQ
狪	tongQQ
獞	tongQS
晍	tongRQ
曈	tongRS
彤	tongS
峂	tongSQ
峝	tongSS
餇	tongST
茼	tongU
蓪	tongUQ
佟	tongV
仝	tongVP
偅	tongVQ
囲	tongWQ
恸	tongX
慟	tongXQ
憅	tongXS
衕	tongXT
酮	tongY
詷	tongYQ
鮦	tongYS
鲖	tongYT
通	tongZ
投	touA
头	touD
斢	touDQ
紏	touFQ
緰	touFS
骰	touG
黈	touHQ
鋀	touJQ
鍮	touJS
妵	touNQ
婾	touNS
媮	touNT
飳	touSQ
埱	touTQ
亠	touTS
蘣	touUQ
偷	touV
偸	touVQ
敨	touWQ
頭	touYQ
透	touZ
抟	tuanA
摶	tuanAQ
剸	tuanDQ
湍	tuanE
湪	tuanEQ
漙	tuanES
煓	tuanHQ
槫	tuanIQ
檲	tuanIS
鏄	tuanJQ
篿	tuanKQ
褖	tuanKS
糰	tuanMQ
鷒	tuanNQ
鷻	tuanNS
猯	tuanQQ
疃	tuanT
塼	tuanTQ
墥	tuanTS
畽	tuanTT
彖	tuanV
团	tuanW
團	tuanWQ
団	tuanWS
圕	tuanWT
慱	tuanXQ
貒	tuanZQ
捈	tuAQ
捸	tuAS
揬	tuAT
摕	tuAU
凃	tuBQ
宊	tuBS
痜	tuBT
瘏	tuBU
徒	tuC
兔	tuD
涂	tuE
兎	tuEQ
汢	tuES
涋	tuET
湥	tuEU
潳	tuEV
庩	tuGQ
廜	tuGS
秃	tuH
禿	tuHQ
稌	tuHS
推	tuiA
蜕	tuiC
蛻	tuiCQ
聉	tuiFQ
隤	tuiFS
弚	tuiGQ
骽	tuiGS
魋	tuiGT
煺	tuiH
穨	tuiHQ
橔	tuiIQ
褪	tuiK
腿	tuiL
駾	tuiMQ
娧	tuiNQ
梌	tuIQ
檡	tuIS
墤	tuiTQ
蓷	tuiUQ
藬	tuiUS
蘈	tuiUT
侻	tuiVQ
俀	tuiVS
僓	tuiVT
颓	tuiY
忒	tuiYP
頹	tuiYQ
尵	tuiYS
讉	tuiYT
頺	tuiYU
頽	tuiYV
退	tuiZ
蹆	tuiZQ
蹪	tuiZS
钍	tuJ
釷	tuJQ
鈯	tuJS
鋀	tuJT
鋵	tuJU
鍎	tuJV
凸	tuK
筡	tuKQ
腯	tuLQ
駼	tuMQ
蛌	tunCQ
軘	tunCS
涒	tunEQ
庉	tunGQ
屯	tunH
焞	tunHQ
黗	tunHS
褪	tunK
豚	tunL
臀	tunLP
朜	tunLQ
臋	tunLS
吞	tunO
呑	tunOQ
啍	tunOS
噋	tunOT
鵌	tuNQ
豘	tunQQ
暾	tunR
旽	tunRQ
霕	tunRS
鵚	tuNS
饨	tunSA
飩	tunSQ
鵵	tuNT
坉	tunTQ
鶟	tuNU
芚	tunUQ
鷋	tuNV
氽	tunVA
鷵	tuNW
囤	tunWA
瓲	tunWQ
忳	tunXQ
憞	tunXS
魨	tunYQ
鲀	tunYS
吐	tuO
托	tuoA
拓	tuoAC
拖	tuoAP
扡	tuoAQ
拕	tuoAS
挩	tuoAT
捝	tuoAU
搨	tuoAV
撱	tuoAW
彵	tuoCQ
沱	tuoE
汑	tuoEQ
沰	tuoES
涶	tuoET
陀	tuoF
紽	tuoFQ
阤	tuoFS
陁	tuoFT
庹	tuoG
椭	tuoI
柝	tuoIC
橐	tuoID
柁	tuoIP
橢	tuoIQ
杔	tuoIS
杝	tuoIT
楕	tuoIU
槖	tuoIV
鉈	tuoJQ
鋖	tuoJS
箨	tuoK
籜	tuoKQ
袉	tuoKS
袥	tuoKT
脱	tuoL
脫	tuoLQ
驼	tuoM
鼍	tuoMC
騨	tuoMN
駞	tuoMO
驮	tuoMP
馱	tuoMQ
駝	tuoMS
鼉	tuoMT
驝	tuoMU
驒	tuoMV
毤	tuoMW
毻	tuoMX
馲	tuoMY
駄	tuoMZ
妥	tuoN
鸵	tuoNP
鴕	tuoNQ
媠	tuoNS
嫷	tuoNT
鵎	tuoNU
唾	tuoO
咃	tuoOQ
咜	tuoOS
啴	tuoOT
嘽	tuoOU
砣	tuoP
乇	tuoPP
砤	tuoPQ
碢	tuoPS
唋	tuOQ
狏	tuoQQ
酡	tuoQR
啚	tuOS
岮	tuoSQ
嶞	tuoSS
飥	tuoST
饦	tuoSU
鼧	tuoSV
坨	tuoT
堶	tuoTQ
莌	tuoUQ
萚	tuoUS
蘀	tuoUT
佗	tuoV
仛	tuoVQ
侂	tuoVS
侻	tuoVT
託	tuoYQ
詑	tuoYS
説	tuoYT
讬	tuoYU
魠	tuoYV
鮀	tuoYW
鮵	tuoYX
鰖	tuoYY
跎	tuoZ
跅	tuoZQ
屠	tuP
酴	tuQ
峹	tuSQ
嵞	tuSS
嶀	tuST
鼵	tuSU
土	tuT
堍	tuTP
塗	tuTQ
圡	tuTS
堗	tuTT
墿	tuTU
荼	tuU
菟	tuUP
莵	tuUQ
葖	tuUS
蒤	tuUT
图	tuW
圖	tuWQ
図	tuWS
圗	tuWT
瑹	tuWU
突	tuX
怢	tuXQ
悇	tuXS
馟	tuXT
途	tuZ
趃	tuZQ
跿	tuZS
迌	tuZT
挖	waA
搲	waAQ
攨	waAS
蛙	waC
徍	waCQ
洼	waE
溛	waEQ
漥	waES
聉	waFQ
邷	waFS
韈	waGQ
瀤	waiEQ
竵	waiLQ
咼	waiOQ
喎	waiOS
崴	waiS
外	waiX
夞	waiXQ
顡	waiYQ
歪	waiZ
帓	waJQ
袜	waK
襪	waKQ
腽	waL
劸	waLQ
膃	waLS
鼃	waMQ
娃	waN
挽	wanA
抏	wanAQ
捖	wanAS
捥	wanAT
掔	wanAU
完	wanB
宛	wanBC
皖	wanBP
貦	wanBQ
贃	wanBS
贎	wanBT
蜿	wanC
輓	wanCQ
蚖	wanCS
蟃	wanCT
輐	wanCU
豌	wanD
剜	wanDP
刓	wanDQ
湾	wanE
灣	wanEQ
汍	wanES
涴	wanET
潫	wanEU
澫	wanEV
绾	wanF
纨	wanFP
紈	wanFQ
絻	wanFS
綄	wanFT
綩	wanFU
綰	wanFV
弯	wanG
抂	wangAQ
往	wangC
辋	wangCP
彺	wangCQ
徃	wangCS
徍	wangCT
蚟	wangCU
蛧	wangCV
蝄	wangCW
輞	wangCX
汪	wangE
瀇	wangEQ
網	wangFQ
魍	wangG
枉	wangI
棢	wangIQ
望	wangL
朚	wangLQ
朢	wangLS
盳	wangMQ
妄	wangN
彎	wanGQ
旺	wangR
兦	wangRQ
暀	wangRS
罒	wangSQ
罓	wangSS
亡	wangT
罔	wangTC
网	wangTP
莣	wangUQ
菵	wangUS
亾	wangVQ
仼	wangVS
王	wangW
忘	wangX
惘	wangXP
忹	wangXQ
尣	wangYQ
尩	wangYS
尪	wangYT
尫	wangYU
誷	wangYV
迋	wangZQ
迬	wangZS
万	wanH
烷	wanHP
杤	wanIQ
杬	wanIS
梚	wanIT
椀	wanIU
槾	wanIV
帵	wanJQ
鋄	wanJS
鋔	wanJT
鋺	wanJU
錽	wanJV
鎫	wanJW
笂	wanKQ
腕	wanL
脘	wanLP
脕	wanLQ
毌	wanMQ
盌	wanMS
睕	wanMT
瞣	wanMU
婉	wanN
妧	wanNQ
婠	wanNS
唍	wanOQ
娲	waNP
碗	wanPA
丸	wanPP
婠	waNQ
晚	wanR
晥	wanRQ
晩	wanRS
晼	wanRT
媧	waNS
卍	wanSQ
卐	wanSS
岏	wanST
畹	wanT
埦	wanTQ
塆	wanTS
壪	wanTT
蔓	wanU
芄	wanUC
菀	wanUD
莞	wanUP
萬	wanUQ
莬	wanUS
萖	wanUT
薍	wanUU
乛	wanVQ
倇	wanVS
玩	wanW
琬	wanWP
琓	wanWQ
惋	wanX
夗	wanXQ
夘	wanXS
忨	wanXT
惌	wanXU
顽	wanY
頑	wanYQ
翫	wanYS
踠	wanZQ
哇	waO
咓	waOQ
咼	waOS
唲	waOT
啘	waOU
嗗	waOV
嗢	waOW
砙	waPQ
屲	waSQ
畖	waTQ
佤	waV
瓦	waW
瓾	waWQ
韎	waWS
韤	waWT
窪	waXQ
穵	waXS
窊	waXT
窐	waXU
鮭	waYQ
捤	weiAQ
捼	weiAS
揋	weiAT
揻	weiAU
撝	weiAV
撱	weiAW
痿	weiB
寪	weiBQ
痏	weiBS
癐	weiBT
癓	weiBU
微	weiC
軎	weiCC
尉	weiCP
蝟	weiCQ
厃	weiCS
徫	weiCT
蜲	weiCU
蜼	weiCV
蝛	weiCW
螱	weiCX
轊	weiCY
为	weiD
渭	weiE
沩	weiEC
涠	weiED
洧	weiEE
潿	weiEN
潙	weiEO
潍	weiEP
瀢	weiEQ
濻	weiES
濰	weiET
洈	weiEU
浘	weiEV
渨	weiEW
湋	weiEX
溈	weiEY
溦	weiEZ
维	weiF
隈	weiFC
隗	weiFD
纬	weiFP
維	weiFQ
緯	weiFS
緭	weiFT
鄬	weiFU
隇	weiFV
颹	weiFW
縅	weiFX
魏	weiG
廆	weiGQ
骩	weiGS
骪	weiGT
骫	weiGU
煨	weiH
炜	weiHP
為	weiHQ
烓	weiHS
煒	weiHT
煟	weiHU
熭	weiHV
燰	weiHW
未	weiI
桅	weiIP
梶	weiIQ
椲	weiIS
椳	weiIT
楲	weiIU
欈	weiIV
卫	weiJ
帏	weiJC
帷	weiJP
幃	weiJQ
覣	weiJS
覹	weiJT
鍏	weiJU
鍡	weiJV
鏏	weiJW
褽	weiKQ
胃	weiL
腲	weiLQ
闱	weiM
瞆	weiMQ
矀	weiMS
闈	weiMT
委	weiN
娓	weiNC
威	weiNP
媁	weiNQ
媙	weiNS
媦	weiNT
犚	weiNU
犩	weiNV
味	weiO
喂	weiOC
唯	weiOP
唩	weiOQ
喡	weiOS
喴	weiOT
尾	weiP
硊	weiPQ
硙	weiPS
碨	weiPT
磈	weiPU
磑	weiPV
猬	weiQ
猥	weiQP
猚	weiQQ
醀	weiQS
暐	weiRQ
霨	weiRS
霺	weiRT
巍	weiS
嵬	weiSC
餧	weiSO
崴	weiSP
饖	weiSQ
餵	weiSS
峗	weiST
峞	weiSU
崣	weiSV
嵔	weiSW
嶉	weiSX
嶶	weiSY
罻	weiSZ
畏	weiT
圩	weiTP
亹	weiTQ
墛	weiTS
壝	weiTT
苇	weiU
蔚	weiUC
薇	weiUD
葳	weiUE
蓶	weiUM
蒍	weiUN
葨	weiUO
萎	weiUP
葦	weiUQ
蘶	weiUS
藯	weiUT
薳	weiUU
蔿	weiUV
芛	weiUW
苿	weiUX
荱	weiUY
菋	weiUZ
位	weiV
伪	weiVC
偎	weiVD
伟	weiVP
偉	weiVQ
偽	weiVS
僞	weiVT
儰	weiVU
围	weiW
韦	weiWC
韪	weiWD
玮	weiWE
韑	weiWO
危	weiWP
圍	weiWQ
韡	weiWS
韙	weiWT
囲	weiWU
斖	weiWV
琟	weiWW
瑋	weiWX
瓗	weiWY
韋	weiWZ
慰	weiX
惟	weiXP
衛	weiXQ
愄	weiXS
愇	weiXT
懀	weiXU
衞	weiXV
谓	weiY
鲔	weiYC
鮇	weiYK
頠	weiYL
讏	weiYM
讆	weiYN
諉	weiYO
诿	weiYP
謂	weiYQ
鳚	weiYS
鳂	weiYT
鰄	weiYU
鰃	weiYV
鮪	weiYW
鮠	weiYX
叞	weiYY
詴	weiYZ
违	weiZ
艉	weiZC
逶	weiZP
違	weiZQ
爲	weiZS
踓	weiZT
躗	weiZU
躛	weiZV
遺	weiZW
揾	wenAQ
搵	wenAS
抆	wenAT
瘟	wenB
瘒	wenBQ
蚊	wenC
蚉	wenCQ
螡	wenCS
蟁	wenCT
輼	wenCU
轀	wenCV
辒	wenCW
刎	wenD
歾	wenDQ
殟	wenDS
温	wenE
汶	wenEP
溫	wenEQ
渂	wenES
纹	wenF
紊	wenFP
紋	wenFQ
聞	wenFS
絻	wenFT
緼	wenFU
縕	wenFV
繧	wenFW
缊	wenFX
攚	wengAQ
齆	wengBQ
螉	wengCQ
奣	wengDQ
滃	wengEQ
罋	wengFQ
聬	wengFS
鎓	wengJQ
勜	wengLQ
瞈	wengMQ
鶲	wengNQ
鹟	wengNS
嗡	wengO
鞰	wenGQ
暡	wengRQ
嵡	wengSQ
塕	wengTQ
蓊	wengU
蕹	wengUP
瓮	wengW
甕	wengWQ
翁	wengY
稳	wenH
穩	wenHQ
炆	wenHS
穏	wenHT
桽	wenIQ
榅	wenIS
榲	wenIT
鎾	wenJQ
肳	wenLQ
脗	wenLS
问	wenM
阌	wenMC
闻	wenMP
閺	wenMQ
閿	wenMS
闅	wenMT
闦	wenMU
馼	wenMV
駇	wenMW
妏	wenNQ
鳼	wenNS
鴍	wenNT
吻	wenO
問	wenOQ
呅	wenOS
呡	wenOT
豱	wenQQ
雯	wenR
昷	wenRQ
彣	wenSQ
饂	wenSS
鼤	wenST
塭	wenTQ
芠	wenUQ
莬	wenUS
蕰	wenUT
伆	wenVQ
文	wenW
璺	wenWC
攵	wenWP
珳	wenWQ
瑥	wenWS
韞	wenWT
忞	wenXQ
忟	wenXS
顐	wenYQ
魰	wenYS
鰛	wenYT
鰮	wenYU
鳁	wenYV
夂	wenZ
呜	wkO
乌	wkP
侮	wkV
悟	wkX
握	woA
挝	woAP
捰	woAQ
捾	woAS
撾	woAT
卧	woB
蜗	woC
龌	woCP
蝸	woCQ
臥	woCS
齷	woCT
沃	woE
渥	woEC
涡	woEP
渦	woEQ
涴	woES
涹	woET
濄	woEU
濣	woEV
緺	woFQ
我	woG
焥	woHQ
枂	woIQ
楃	woIS
幄	woJ
肟	woL
腛	woLQ
臒	woLS
龏	woLT
瞃	woMQ
婐	woNQ
婑	woNS
媉	woNT
媼	woNU
喔	woO
咼	woOQ
唩	woOS
硪	woP
猧	woQQ
斡	woS
莴	woU
萵	woUQ
薶	woUS
倭	woV
仴	woVQ
偓	woVS
瓁	woWQ
窝	woX
窩	woXQ
馧	woXS
踒	woZQ
捂	wuA
扜	wuAQ
扝	wuAS
扤	wuAT
摀	wuAU
勿	wuB
寤	wuBC
痦	wuBP
鼿	wuBQ
齀	wuBS
蜈	wuC
螐	wuCQ
蟱	wuCS
剭	wuDQ
奦	wuDS
污	wuE
浯	wuEQ
汙	wuES
汚	wuET
沕	wuEU
洖	wuEV
洿	wuEW
渞	wuEX
溩	wuEY
潕	wuEZ
邬	wuF
阢	wuFP
郚	wuFQ
鄔	wuFS
陚	wuFT
隖	wuFU
巫	wuG
庑	wuGC
戊	wuGP
廡	wuGQ
弙	wuGS
靰	wuGT
无	wuH
兀	wuHC
焐	wuHD
五	wuHP
烏	wuHQ
無	wuHS
熃	wuHT
熓	wuHU
梧	wuI
杌	wuIP
杅	wuIQ
杇	wuIS
柮	wuIT
橆	wuIU
钨	wuJ
鋈	wuJP
卼	wuJQ
釫	wuJS
鋘	wuJT
鋙	wuJU
鎢	wuJV
铻	wuJW
箼	wuKQ
务	wuL
務	wuLQ
膴	wuLS
毋	wuM
骛	wuMP
瞴	wuMQ
粅	wuMS
騖	wuMT
物	wuN
妩	wuNC
婺	wuND
鹜	wuNE
牾	wuNF
鶩	wuNO
鹉	wuNP
鵡	wuNQ
鹀	wuNS
鷡	wuNT
娒	wuNU
娪	wuNV
娬	wuNW
嫵	wuNX
鴮	wuNY
鵐	wuNZ
吴	wuO
呜	wuOC
唔	wuOD
吾	wuOP
吳	wuOQ
嗚	wuOS
呉	wuOT
啎	wuOU
屋	wuP
乌	wuPC
午	wuPP
矹	wuPQ
碔	wuPS
歍	wuQQ
雾	wuR
晤	wuRP
霧	wuRQ
旿	wuRS
雺	wuRT
霚	wuRU
鼯	wuS
屼	wuSQ
岉	wuSS
峿	wuST
嵍	wuSU
嵨	wuSV
祦	wuSW
坞	wuT
圬	wuTO
堥	wuTQ
塢	wuTS
墲	wuTT
芜	wuU
芴	wuUP
蕪	wuUQ
茣	wuUS
莁	wuUT
蘁	wuUU
伍	wuV
仵	wuVC
侮	wuVP
亾	wuVQ
俉	wuVS
倵	wuVT
僫	wuVU
儛	wuVV
乄	wuVW
敄	wuWQ
玝	wuWS
珷	wuWT
珸	wuWU
瑦	wuWV
璑	wuWW
甒	wuWX
舞	wuX
悟	wuXC
忤	wuXD
怃	wuXE
恶	wuXP
惡	wuXQ
忢	wuXS
悞	wuXT
悮	wuXU
憮	wuXV
窏	wuXW
窹	wuXX
误	wuY
诬	wuYP
誣	wuYQ
誤	wuYS
誈	wuYT
譕	wuYU
鯃	wuYV
鰞	wuYW
武	wuZ
迕	wuZP
趶	wuZQ
躌	wuZS
逜	wuZT
捾	xiaAQ
疜	xiaBQ
疨	xiaBS
辖	xiaC
虾	xiaCC
厦	xiaCP
蝦	xiaCQ
轄	xiaCS
徦	xiaCT
螛	xiaCU
赮	xiaCV
厦	xiaD
夾	xiaDQ
匣	xiaF
罅	xiaFP
縖	xiaFQ
陜	xiaFS
陿	xiaFT
颬	xiaFU
廈	xiaGQ
谺	xiaGS
下	xiaH
黠	xiaHP
丅	xiaHQ
炠	xiaHS
烚	xiaHT
煆	xiaHU
柙	xiaI
梺	xiaIQ
鍜	xiaJQ
鎋	xiaJS
鎼	xiaJT
鏬	xiaJU
笚	xiaKQ
筪	xiaKS
瞎	xiaM
睱	xiaMQ
閕	xiaMS
閜	xiaMT
騢	xiaMU
掀	xianA
摻	xianAQ
挦	xianAS
搚	xianAT
搟	xianAU
撊	xianAV
撏	xianAW
攇	xianAX
攕	xianAY
宪	xianB
冼	xianBC
痫	xianBD
贤	xianBP
賢	xianBQ
癇	xianBS
癎	xianBT
贒	xianBU
衔	xianC
蚬	xianCP
臤	xianCQ
蚿	xianCS
蛝	xianCT
蜆	xianCU
軐	xianCV
輱	xianCW
豏	xianDQ
先	xianE
涎	xianEP
涀	xianEQ
湺	xianES
溓	xianET
澖	xianEU
瀗	xianEV
灦	xianEW
线	xianF
险	xianFC
陷	xianFD
纤	xianFE
繊	xianFK
縣	xianFL
綫	xianFM
綖	xianFN
綅	xianFO
限	xianFP
險	xianFQ
纖	xianFS
線	xianFT
険	xianFU
陥	xianFV
缐	xianFW
纎	xianFX
絃	xianFY
絤	xianFZ
弦	xianG
厢	xiangC
蟓	xiangCP
忀	xiangCQ
蚃	xiangCS
蠁	xiangCT
湘	xiangE
潒	xiangEQ
降	xiangF
缃	xiangFP
鄉	xiangFQ
絴	xiangFS
緗	xiangFT
纕	xiangFU
缿	xiangFV
郷	xiangFW
鄊	xiangFX
鄕	xiangFY
庠	xiangG
廂	xiangGQ
相	xiangI
橡	xiangIP
栙	xiangIQ
欀	xiangIS
楿	xiangIT
镶	xiangJ
鑲	xiangJQ
銄	xiangJS
銗	xiangJT
鐌	xiangJU
箱	xiangK
襐	xiangKQ
勨	xiangLQ
勷	xiangLS
膷	xiangLT
麘	xiangLU
骧	xiangM
閧	xiangMQ
闂	xiangMS
驤	xiangMT
姠	xiangNQ
向	xiangO
响	xiangOP
啍	xiangOQ
嚮	xiangOS
廯	xianGQ
晑	xiangRQ
曏	xiangRS
象	xiangS
巷	xiangSC
饷	xiangSD
飨	xiangSE
祥	xiangSP
嶑	xiangSQ
韅	xianGSR
餉	xiangSS
饗	xiangST
饟	xiangSU
享	xiangT
襄	xiangTP
亯	xiangTQ
芗	xiangU
葙	xiangUP
萫	xiangUQ
薌	xiangUS
像	xiangV
乡	xiangVP
佭	xiangVQ
儴	xiangVS
珦	xiangWQ
瓖	xiangWS
瓨	xiangWT
想	xiangX
香	xiangXP
衖	xiangXQ
项	xiangY
翔	xiangYC
鲞	xiangYD
详	xiangYP
響	xiangYQ
項	xiangYS
羏	xiangYT
詳	xiangYU
鮝	xiangYV
鯗	xiangYW
鱌	xiangYX
鱶	xiangYY
鱜	xiangYZ
夅	xiangZQ
跭	xiangZS
燹	xianH
烍	xianHQ
秈	xianHS
稴	xianHT
杴	xianIQ
枮	xianIS
槏	xianIT
橌	xianIU
橺	xianIV
櫶	xianIW
见	xianJ
铣	xianJC
鋧	xianJI
銽	xianJJ
銛	xianJK
銑	xianJL
臽	xianJM
幰	xianJN
錎	xianJO
锨	xianJP
見	xianJQ
銜	xianJS
韱	xianJT
韯	xianJU
铦	xianJV
鑦	xianJW
鏾	xianJX
鍌	xianJY
鍁	xianJZ
筅	xianK
箲	xianKQ
褼	xianKS
襳	xianKT
腺	xianL
胘	xianLQ
臔	xianLS
鹹	xianLT
麙	xianLU
闲	xianM
糮	xianMO
籼	xianMP
閑	xianMQ
麲	xianMS
閒	xianMT
毨	xianMU
盷	xianMV
県	xianMW
睍	xianMX
瞯	xianMY
粯	xianMZ
嫌	xianN
鹇	xianNC
嫺	xianNJ
婱	xianNK
娹	xianNL
娊	xianNM
姺	xianNN
姭	xianNO
娴	xianNP
鷼	xianNQ
鷴	xianNS
鷳	xianNT
鶱	xianNU
孅	xianNV
嬐	xianNW
嫻	xianNX
奾	xianNY
妶	xianNZ
咸	xianO
咁	xianOQ
咞	xianOS
哯	xianOT
唌	xianOU
啣	xianOV
嗛	xianOW
嘕	xianOX
硍	xianPQ
礥	xianPS
献	xianQ
氙	xianQC
猃	xianQD
酰	xianQP
獻	xianQQ
鶷	xiaNQR
欦	xianQS
狝	xianQT
獫	xianQU
獮	xianQV
玁	xianQW
醎	xianQX
醶	xianQY
显	xianR
霰	xianRP
晛	xianRQ
县	xianS
岘	xianSC
祆	xianSD
馅	xianSP
餡	xianSQ
屳	xianSS
峴	xianST
崄	xianSU
嶮	xianSV
禒	xianSW
鼸	xianSX
垷	xianTQ
埳	xianTS
塪	xianTT
壏	xianTU
藓	xianU
莶	xianUC
苋	xianUP
苮	xianUQ
莧	xianUS
薟	xianUT
藖	xianUU
蘚	xianUV
仙	xianV
仚	xianVQ
伭	xianVS
佡	xianVT
僊	xianVU
僩	xianVV
僲	xianVW
僴	xianVX
现	xianW
現	xianWQ
玹	xianWS
珗	xianWT
甉	xianWU
憲	xianXQ
馦	xianXS
尟	xianXT
尠	xianXU
忺	xianXV
憪	xianXW
憸	xianXX
懢	xianXY
衘	xianXZ
鲜	xianY
顕	xianYO
羡	xianYP
鮮	xianYQ
顯	xianYS
鱻	xianYT
羨	xianYU
羬	xianYV
誢	xianYW
誸	xianYX
諴	xianYY
譣	xianYZ
舷	xianZ
跹	xianZC
跣	xianZD
暹	xianZP
赻	xianZQ
蹮	xianZS
躚	xianZT
吓	xiaO
揱	xiaoAQ
撨	xiaoAS
宵	xiaoB
宯	xiaoBQ
痚	xiaoBS
痟	xiaoBT
皛	xiaoBU
皢	xiaoBV
蛸	xiaoC
蟂	xiaoCQ
蟏	xiaoCS
蟰	xiaoCT
蠨	xiaoCU
削	xiaoD
消	xiaoE
淆	xiaoEC
潇	xiaoEP
瀟	xiaoEQ
洨	xiaoES
涍	xiaoET
绡	xiaoF
綃	xiaoFQ
郩	xiaoFS
颵	xiaoFT
魈	xiaoG
庨	xiaoGQ
彇	xiaoGS
骹	xiaoGT
髇	xiaoGU
髐	xiaoGV
灱	xiaoHQ
灲	xiaoHS
烋	xiaoHT
焇	xiaoHU
熇	xiaoHV
熽	xiaoHW
穘	xiaoHX
虓	xiaoHY
校	xiaoI
枵	xiaoIC
枭	xiaoIP
梟	xiaoIQ
櫹	xiaoIS
销	xiaoJ
銷	xiaoJQ
﨧	xiaoJS
笑	xiaoK
筱	xiaoKC
箫	xiaoKP
簫	xiaoKQ
筿	xiaoKS
箾	xiaoKT
篠	xiaoKU
簘	xiaoKV
肖	xiaoL
効	xiaoLQ
膮	xiaoLS
骁	xiaoM
睄	xiaoMQ
驍	xiaoMS
婋	xiaoNQ
鴞	xiaoNS
鴵	xiaoNT
鷍	xiaoNU
鸮	xiaoNV
啸	xiaoO
哮	xiaoOC
哓	xiaoOD
嘵	xiaoOO
嚣	xiaoOP
囂	xiaoOQ
嘯	xiaoOS
嚻	xiaoOT
呺	xiaoOU
咲	xiaoOV
嗃	xiaoOW
嘋	xiaoOX
嘐	xiaoOY
嘨	xiaoOZ
硝	xiaoP
殽	xiaoPQ
呷	xiaoPR
毊	xiaoPS
硣	xiaoPT
嚇	xiaOQ
歊	xiaoQQ
歗	xiaoQS
猇	xiaoQT
獟	xiaoQU
獢	xiaoQV
晓	xiaoR
霄	xiaoRP
曉	xiaoRQ
暁	xiaoRS
崤	xiaoS
萧	xiaoU
蕭	xiaoUQ
莦	xiaoUS
薂	xiaoUT
藃	xiaoUU
虈	xiaoUV
侾	xiaoVQ
俲	xiaoVS
傚	xiaoVT
效	xiaoW
敩	xiaoWQ
斅	xiaoWS
斆	xiaoWT
小	xiaoX
恔	xiaoXQ
憢	xiaoXS
窙	xiaoXT
翛	xiaoYQ
訤	xiaoYS
詨	xiaoYT
誟	xiaoYU
誵	xiaoYV
謏	xiaoYW
孝	xiaoZ
逍	xiaoZP
踃	xiaoZQ
硖	xiaP
硤	xiaPQ
碬	xiaPS
磍	xiaPT
狭	xiaQ
狎	xiaQP
狹	xiaQQ
猇	xiaQS
霞	xiaR
暇	xiaRP
峡	xiaS
峽	xiaSQ
祫	xiaSS
扸	xiAT
圷	xiaTQ
埉	xiaTS
摡	xiAU
芐	xiaUQ
蕸	xiaUS
侠	xiaV
俠	xiaVQ
傄	xiaVS
瑕	xiaW
敮	xiaWQ
珨	xiaWS
舝	xiaWT
扢	xiAX
懗	xiaXQ
扱	xiAY
叚	xiaYQ
翈	xiaYS
諕	xiaYT
魻	xiaYU
鰕	xiaYV
夏	xiaZ
遐	xiaZP
夓	xiaZQ
舺	xiaZS
兮	xiB
皙	xiBP
凞	xiBQ
卥	xiBS
瘜	xiBT
徙	xiC
蜥	xiCC
螅	xiCD
蟋	xiCP
徆	xiCQ
徯	xiCS
螇	xiCT
蟢	xiCU
蠵	xiCV
赥	xiCW
赩	xiCX
奚	xiD
鬩	xiDQ
洗	xiE
携	xieA
撷	xieAC
挟	xieAP
挾	xieAQ
攜	xieAS
拹	xieAT
揳	xieAU
搚	xieAV
擕	xieAW
擷	xieAX
寫	xieBQ
卨	xieBS
齂	xieBT
汐	xiEC
蟹	xieCA
蝎	xieCP
徢	xieCQ
蝢	xieCS
蠍	xieCT
蠏	xieCU
齘	xieCV
齛	xieCW
齥	xieCX
斜	xieD
奊	xieDQ
些	xieE
泻	xieEC
瀣	xieED
渫	xieEE
泄	xieEP
瀉	xieEQ
洩	xieES
滊	xieET
澥	xieEU
邪	xieF
绁	xieFC
縀	xieFN
緳	xieFO
缬	xieFP
缷	xieFQ
纈	xieFS
繲	xieFT
紲	xieFU
絏	xieFV
絜	xieFW
絬	xieFX
綊	xieFY
緤	xieFZ
鞋	xieG
廨	xieGP
靾	xieGQ
鞢	xieGS
鞵	xieGT
浠	xiEH
灺	xieHQ
炧	xieHS
炨	xieHT
烲	xieHU
焎	xieHV
熁	xieHW
燲	xieHX
爕	xieHY
械	xieI
榭	xieIC
榍	xieID
楔	xieIP
枻	xieIQ
栧	xieIS
梋	xieIT
榝	xieIU
樧	xieIV
卸	xieJ
觟	xieJQ
觧	xieJS
韰	xieJT
淅	xiEK
衺	xieKQ
褉	xieKS
褻	xieKT
襭	xieKU
胁	xieL
勰	xieLP
脅	xieLQ
劦	xieLS
脇	xieLT
脋	xieLU
膎	xieLV
写	xieM
冩	xieMQ
糏	xieMS
娎	xieNQ
媟	xieNS
孈	xieNT
禼	xieNU
滊	xiEO
嗋	xieOQ
噧	xieOS
嚡	xieOT
溪	xiEP
屑	xiePA
屟	xiePQ
屧	xiePS
碿	xiePT
渓	xiEQ
歇	xieQA
獬	xieQP
猲	xieQQ
獦	xieQS
旪	xieRQ
暬	xieRS
协	xieS
協	xieSQ
峫	xieSS
嶰	xieST
祄	xieSU
漇	xiET
亵	xieTA
垥	xieTQ
塮	xieTS
漝	xiEU
薢	xieUQ
薤	xieUR
藛	xieUS
潝	xiEV
偕	xieVA
伳	xieVQ
偞	xieVS
偰	xieVT
僁	xieVU
儶	xieVV
潟	xiEW
瑎	xieWQ
韘	xieWS
澙	xiEX
懈	xieXA
恊	xieXQ
愶	xieXS
慀	xieXT
谢	xieY
燮	xieYC
颉	xieYD
谐	xieYP
諧	xieYQ
謝	xieYS
翓	xieYT
讗	xieYU
頡	xieYV
鮭	xieYW
龤	xieYX
邂	xieZ
躞	xieZC
蹀	xieZP
夑	xieZQ
躠	xieZS
系	xiF
隙	xiFC
郗	xiFD
隰	xiFE
繫	xiFG
繥	xiFH
縰	xiFI
縘	xiFJ
緆	xiFK
綌	xiFL
匸	xiFM
纚	xiFN
绤	xiFO
细	xiFP
細	xiFQ
隵	xiFS
飁	xiFT
隟	xiFU
酅	xiFV
鄎	xiFW
郤	xiFX
郋	xiFY
邜	xiFZ
戏	xiG
戲	xiGQ
戯	xiGS
戱	xiGT
谿	xiGU
豀	xiGV
稀	xiH
烯	xiHC
熄	xiHD
熹	xiHE
熺	xiHK
熈	xiHL
熂	xiHM
煕	xiHN
焬	xiHO
熙	xiHP
黖	xiHQ
虩	xiHS
稧	xiHT
爔	xiHU
燨	xiHV
熻	xiHW
焁	xiHX
焈	xiHY
焟	xiHZ
析	xiI
檄	xiIC
樨	xiID
槢	xiIO
栖	xiIP
棲	xiIQ
橲	xiIS
橀	xiIT
杫	xiIU
枲	xiIV
桸	xiIW
椞	xiIX
椺	xiIY
榽	xiIZ
希	xiJ
锡	xiJC
铣	xiJD
觋	xiJE
舄	xiJF
席	xiJP
厀	xiJQ
舃	xiJS
覡	xiJT
覤	xiJU
觹	xiJV
觽	xiJW
觿	xiJX
釳	xiJY
裼	xiK
襲	xiKQ
膝	xiL
臘	xiLQ
釐	xiLS
肸	xiLT
肹	xiLU
粞	xiM
阋	xiMP
驨	xiMQ
盻	xiMS
睎	xiMT
瞦	xiMU
矖	xiMV
糦	xiMW
闟	xiMX
騱	xiMY
騽	xiMZ
媳	xiN
嬉	xiNC
軐	xinCQ
犀	xiND
邤	xinFQ
阠	xinFS
擤	xingA
兴	xingB
皨	xingBQ
行	xingC
巠	xingCQ
蛵	xingCS
刑	xingD
洐	xingEQ
涬	xingES
滎	xingET
邢	xingF
陉	xingFP
緈	xingFQ
郉	xingFS
陘	xingFT
煋	xingHQ
杏	xingI
﨨	xingJO
興	xingJQ
铏	xingJS
觪	xingJT
觲	xingJU
鈃	xingJV
鉶	xingJW
銒	xingJX
鋞	xingJY
钘	xingJZ
箵	xingKQ
篂	xingKS
腥	xingL
臖	xingLQ
省	xingM
睲	xingMQ
騂	xingMS
骍	xingMT
姓	xingN
娙	xingNQ
婞	xingNS
嬹	xingNT
哘	xingOQ
硎	xingP
醒	xingQ
猩	xingQP
狌	xingQQ
廞	xinGQR
星	xingR
曐	xingRQ
形	xingS
饧	xingSP
餳	xingSQ
型	xingT
幸	xingTP
垶	xingTQ
荥	xingU
荇	xingUP
莕	xingUQ
葕	xingUS
侀	xingVQ
倖	xingVS
瑆	xingWQ
性	xingX
悻	xingXC
惺	xingXP
謃	xingYQ
鮏	xingYS
鯹	xingYT
炘	xinHQ
焮	xinHS
杺	xinIQ
枔	xinIS
新	xinJ
鑫	xinJC
镡	xinJD
锌	xinJP
鋅	xinJQ
舋	xinJS
鈊	xinJT
鐔	xinJU
襑	xinKQ
脪	xinLQ
盺	xinMQ
馸	xinMS
犧	xiNN
妡	xinNQ
嬜	xinNS
犔	xiNO
噷	xinOQ
噺	xinOS
牺	xiNP
礥	xinPQ
囟	xinPR
欣	xinQ
歆	xinQP
釁	xinQQ
昕	xinR
娭	xiNS
嬆	xiNT
薪	xinU
莘	xinUC
芯	xinUP
信	xinV
伈	xinVQ
伩	xinVS
俽	xinVT
鵗	xiNW
心	xinX
馨	xinXC
衅	xinXD
忻	xinXE
辛	xinXP
惞	xinXQ
愖	xinXS
忄	xinXT
馫	xinXU
犠	xiNY
訢	xinYQ
訫	xinYS
顖	xinYT
鸂	xiNZ
孞	xinZQ
吸	xiO
嘻	xiOC
唏	xiOD
匈	xiongB
匂	xiongBQ
賯	xiongBS
兄	xiongE
汹	xiongEP
洶	xiongEQ
兇	xiongES
熊	xiongH
焸	xiongHQ
焽	xiongHS
熋	xiongHT
凶	xiongK
胸	xiongL
胷	xiongLQ
哅	xiongOQ
芎	xiongU
敻	xiongWQ
忷	xiongXQ
恟	xiongXS
訩	xiongYQ
詗	xiongYS
詾	xiongYT
讻	xiongYU
诇	xiongYV
雄	xiongZ
夐	xiongZQ
喜	xiOP
呬	xiOQ
咥	xiOS
唽	xiOT
喺	xiOU
噏	xiOV
嚱	xiOW
囍	xiOX
硒	xiP
屣	xiPC
矽	xiPP
屃	xiPQ
屓	xiPS
屖	xiPT
屭	xiPU
碏	xiPV
磎	xiPW
磶	xiPX
礂	xiPY
歙	xiQ
醯	xiQC
欷	xiQP
欪	xiQQ
欯	xiQS
歖	xiQT
氥	xiQU
狶	xiQV
獡	xiQW
豨	xiQX
豯	xiQY
晰	xiR
曦	xiRC
昔	xiRP
晞	xiRQ
晳	xiRS
暿	xiRT
雭	xiRU
霫	xiRV
霼	xiRW
禧	xiS
饩	xiSC
禊	xiSD
餼	xiSO
鼷	xiSP
饻	xiSQ
饎	xiSS
卌	xiST
嵠	xiSU
嶍	xiSV
嶲	xiSW
巂	xiSX
巇	xiSY
餏	xiSZ
塈	xiTQ
塜	xiTS
墍	xiTT
壐	xiTU
茜	xiU
髹	xiuB
髤	xiuBQ
齅	xiuBS
葸	xiUC
螑	xiuCQ
蓰	xiUD
溴	xiuE
滫	xiuEQ
潃	xiuES
绣	xiuF
繡	xiuFQ
綉	xiuFS
繍	xiuFT
飍	xiuFU
庥	xiuG
秀	xiuH
烌	xiuHQ
朽	xiuI
樇	xiuIQ
锈	xiuJ
銹	xiuJQ
銝	xiuJS
鎀	xiuJT
鏅	xiuJU
鏥	xiuJV
鏽	xiuJW
袖	xiuK
褎	xiuKQ
褏	xiuKS
薂	xiUL
脙	xiuLQ
脩	xiuLS
蒵	xiUM
糔	xiuMQ
鸺	xiuN
鵂	xiuNQ
嗅	xiuO
咻	xiuOP
嚊	xiuOQ
菥	xiUP
莃	xiUQ
葈	xiUS
馐	xiuSP
峀	xiuSQ
岫	xiuSR
饈	xiuSS
蒠	xiUT
蒨	xiUU
苬	xiuUQ
修	xiuV
休	xiuVP
俢	xiuVQ
蓆	xiUW
珛	xiuWQ
琇	xiuWS
璓	xiuWT
蕮	xiUX
羞	xiuY
鮴	xiuYQ
鱃	xiuYS
臭	xiuZ
貅	xiuZP
臹	xiuZQ
习	xiV
僖	xiVP
係	xiVQ
俙	xiVS
傒	xiVT
玺	xiW
琋	xiWQ
璽	xiWS
瓕	xiWT
西	xiX
惜	xiXC
悉	xiXD
夕	xiXE
穸	xiXF
惁	xiXK
悕	xiXL
恓	xiXM
恄	xiXN
怸	xiXO
息	xiXP
衋	xiXQ
窸	xiXS
憙	xiXT
憘	xiXU
慀	xiXV
愾	xiXW
忚	xiXX
忥	xiXY
怬	xiXZ
袭	xiY
羲	xiYC
鯑	xiYL
譆	xiYM
謵	xiYN
謑	xiYO
翕	xiYP
習	xiYQ
鳛	xiYS
鱚	xiYT
鰼	xiYU
鰓	xiYV
羛	xiYW
翖	xiYX
誒	xiYY
諰	xiYZ
蹊	xiZ
舾	xiZP
貕	xiZQ
趇	xiZS
趘	xiZT
蹝	xiZU
躧	xiZV
雟	xiZW
揎	xuanA
宣	xuanB
痃	xuanBC
癣	xuanBP
癬	xuanBQ
贙	xuanBS
轩	xuanC
軒	xuanCQ
蜁	xuanCS
蝖	xuanCT
蠉	xuanCU
渲	xuanE
泫	xuanEC
漩	xuanEP
旋	xuanF
绚	xuanFP
絢	xuanFQ
縣	xuanFS
縼	xuanFT
繏	xuanFU
颴	xuanFV
縇	xuanFW
弲	xuanGQ
鞙	xuanGS
炫	xuanH
煊	xuanHP
烜	xuanHQ
煖	xuanHS
楦	xuanI
梋	xuanIQ
楥	xuanIS
檈	xuanIT
镟	xuanJ
铉	xuanJP
鉉	xuanJQ
鋗	xuanJS
鍹	xuanJT
鏇	xuanJU
箮	xuanKQ
袨	xuanKS
眩	xuanM
眴	xuanMQ
睻	xuanMS
矎	xuanMT
駨	xuanMU
駽	xuanMV
妶	xuanNQ
媗	xuanNS
嫙	xuanNT
嬛	xuanNU
喧	xuanO
吅	xuanOQ
咺	xuanOS
喛	xuanOT
碹	xuanP
暄	xuanR
昍	xuanRQ
昡	xuanRS
晅	xuanRT
暅	xuanRU
暶	xuanRV
禤	xuanSQ
塇	xuanTQ
萱	xuanU
萲	xuanUQ
蓒	xuanUS
蔙	xuanUT
蕿	xuanUU
藼	xuanUV
蘐	xuanUW
儇	xuanV
伭	xuanVQ
璇	xuanW
敻	xuanWQ
玹	xuanWS
琁	xuanWT
琄	xuanWU
瑄	xuanWV
璿	xuanWW
悬	xuanX
玄	xuanXP
懸	xuanXQ
怰	xuanXS
愃	xuanXT
愋	xuanXU
懁	xuanXV
衒	xuanXW
谖	xuanY
翧	xuanYQ
翾	xuanYS
諠	xuanYT
諼	xuanYU
譞	xuanYV
讂	xuanYW
鰚	xuanYX
选	xuanZ
選	xuanZQ
夐	xuanZS
掝	xuAQ
揟	xuAS
疞	xuBQ
賉	xuBS
鬚	xuBT
徐	xuC
蚼	xuCQ
蛡	xuCS
蝑	xuCT
殈	xuDQ
洫	xuE
疦	xueBQ
疶	xueBS
轌	xueCQ
削	xueD
泶	xueE
泬	xueEQ
滈	xueES
澩	xueET
瀥	xueEU
靴	xueG
鞾	xueGQ
燢	xueHQ
桖	xueIQ
樰	xueIS
觷	xueJQ
袕	xueKQ
膤	xueLQ
滀	xuEM
瞲	xueMQ
漵	xuEN
鷽	xueNQ
鸴	xueNS
噱	xueO
吷	xueOQ
溆	xuEP
潊	xuEQ
狘	xueQQ
雪	xueR
汿	xuES
岤	xueSQ
峃	xueSS
嶨	xueST
沀	xuET
坹	xueTQ
壆	xueTS
淢	xuEU
薛	xueUA
茓	xueUQ
蒆	xueUS
湏	xuEV
乴	xueVQ
湑	xuEW
敩	xueWQ
斆	xueWS
斈	xueWT
血	xueX
穴	xueXP
怴	xueXQ
辥	xueXS
辪	xueXT
彐	xueXU
滸	xuEY
谑	xueYA
鳕	xueYP
謔	xueYQ
鱈	xueYS
学	xueZ
踅	xueZP
學	xueZQ
趐	xueZS
艝	xueZT
续	xuF
絮	xuFC
繻	xuFN
縃	xuFO
绪	xuFP
緒	xuFQ
續	xuFS
鄦	xuFT
聟	xuFU
聓	xuFV
綇	xuFW
続	xuFX
緖	xuFY
緰	xuFZ
序	xuG
戌	xuGP
魆	xuGQ
魖	xuGS
虚	xuH
煦	xuHP
虛	xuHQ
烅	xuHS
烼	xuHT
燸	xuHU
稰	xuHV
稸	xuHW
虗	xuHX
嘘	xuI
栩	xuIP
楈	xuIQ
槒	xuIS
卹	xuJQ
銊	xuJS
鑐	xuJT
裇	xuKQ
肷	xuL
勖	xuLP
勗	xuLQ
盱	xuM
糈	xuMP
盢	xuMQ
盨	xuMS
眗	xuMT
瞁	xuMU
矞	xuMV
驉	xuMW
婿	xuN
揗	xunAQ
巽	xunB
寻	xunC
巡	xunCC
徇	xunCD
循	xunCP
尋	xunCQ
蟫	xunCS
蟳	xunCT
殉	xunD
奞	xunDQ
汛	xunE
浚	xunEC
浔	xunED
洵	xunEP
巺	xunEQ
潠	xunES
潯	xunET
濬	xunEU
灥	xunEV
郇	xunF
紃	xunFQ
纁	xunFS
鄩	xunFT
熏	xunH
焄	xunHQ
煇	xunHS
燅	xunHT
燖	xunHU
燻	xunHV
爋	xunHW
爓	xunHX
稄	xunHY
杊	xunIQ
栒	xunIS
桪	xunIT
樳	xunIU
鑂	xunJQ
勋	xunL
勛	xunLQ
勲	xunLS
勳	xunLT
臐	xunLU
驯	xunM
馴	xunMQ
毥	xunMS
眴	xunMT
矄	xunMU
駨	xunMV
姰	xunNQ
鶽	xunNS
咰	xunOQ
噀	xunOS
噚	xunOT
嚑	xunOU
殾	xunPQ
妶	xuNQ
醺	xunQA
獯	xunQP
狥	xunQQ
旬	xunR
曛	xunRP
姁	xuNS
峋	xunSA
卂	xunSQ
媭	xuNT
埙	xunTA
坃	xunTQ
塤	xunTS
壎	xunTT
壦	xunTU
畃	xunTV
嬃	xuNU
荀	xunUA
荨	xunUC
蕈	xunUD
薰	xunUP
葷	xunUQ
蕁	xunUS
薫	xunUT
蘍	xunUU
伨	xunVQ
侚	xunVS
偱	xunVT
珣	xunWQ
璕	xunWS
窨	xunX
恂	xunXP
愻	xunXQ
训	xunY
询	xunYC
鲟	xunYD
讯	xunYP
訊	xunYQ
訓	xunYS
詢	xunYT
廵	xunYU
訙	xunYV
顨	xunYW
鱏	xunYX
鱘	xunYY
迅	xunZ
逊	xunZP
孫	xunZQ
遜	xunZS
攳	xunZT
迿	xunZU
吁	xuO
呴	xuOQ
喐	xuOS
喣	xuOT
嘼	xuOU
噓	xuOV
酗	xuQ
醑	xuQP
欨	xuQQ
欰	xuQS
欻	xuQT
歔	xuQU
歘	xuQV
獝	xuQW
需	xuR
旭	xuRP
旴	xuRQ
昫	xuRS
晇	xuRT
暊	xuRU
朂	xuRV
须	xuS
壻	xuSQ
禑	xuSS
畜	xuT
圩	xuTC
墟	xuTP
冔	xuTQ
垿	xuTS
﨏	xuTT
蓄	xuU
蓿	xuUP
芧	xuUQ
蒣	xuUS
蓲	xuUT
蕦	xuUU
藇	xuUV
藚	xuUW
伵	xuVQ
侐	xuVS
俆	xuVT
偦	xuVU
顼	xuW
敘	xuWQ
敍	xuWS
珝	xuWT
珬	xuWU
恤	xuX
怴	xuXQ
恓	xuXS
惐	xuXT
慉	xuXU
许	xuY
诩	xuYC
谞	xuYM
譃	xuYN
諿	xuYO
叙	xuYP
須	xuYQ
許	xuYS
鱮	xuYT
魣	xuYU
頊	xuYV
訏	xuYW
訹	xuYX
詡	xuYY
諝	xuYZ
胥	xuZ
銑	xzJM
鐊	xzJN
鉩	xzJO
錫	xzJQ
鎴	xzJS
鏭	xzJT
釸	xzJU
鈒	xzJV
鈢	xzJW
钑	xzJX
鉨	xzJY
鑴	xzJZ
押	yaA
揠	yaAP
拁	yaAQ
挜	yaAS
掗	yaAT
痖	yaB
冴	yaBQ
疨	yaBS
瘂	yaBT
压	yaC
衙	yaCC
蚜	yaCD
轧	yaCP
軋	yaCQ
厊	yaCS
厓	yaCT
厭	yaCU
齖	yaCV
齾	yaCW
厑	yaCX
涯	yaE
漄	yaEQ
潝	yaES
聐	yaFQ
庌	yaGQ
庘	yaGS
亚	yaH
亞	yaHQ
亜	yaHS
稏	yaHT
桠	yaI
枒	yaIQ
椏	yaIS
椻	yaIT
釾	yaJQ
錏	yaJS
鐚	yaJT
铔	yaJU
笌	yaKQ
丫	yaL
劜	yaLQ
睚	yaM
鸭	yaN
掩	yanA
抁	yanAQ
掞	yanAS
揅	yanAT
揜	yanAU
宴	yanB
贋	yanBQ
贗	yanBS
娅	yaNC
厌	yanCA
蜒	yanCC
赝	yanCD
厣	yanCE
衍	yanCP
厭	yanCQ
厳	yanCS
厴	yanCT
蝘	yanCU
齞	yanCV
齴	yanCW
奄	yanD
剡	yanDP
剦	yanDQ
夵	yanDS
殗	yanDT
演	yanE
淹	yanEC
湮	yanED
滟	yanEE
漹	yanEM
溎	yanEN
渷	yanEO
沿	yanEP
灩	yanEQ
灧	yanES
灔	yanET
灎	yanEU
兗	yanEV
沇	yanEW
洝	yanEX
淊	yanEY
渰	yanEZ
鄢	yanF
郾	yanFP
隒	yanFQ
匽	yanFS
綖	yanFT
縯	yanFU
豓	yanFV
豔	yanFW
郔	yanFX
酀	yanFY
隁	yanFZ
魇	yanG
扬	yangA
揚	yangAQ
抰	yangAS
攁	yangAT
养	yangB
疡	yangBC
痒	yangBP
癢	yangBQ
瘍	yangBS
徉	yangC
蛘	yangCP
蝆	yangCQ
軮	yangCS
輰	yangCT
央	yangD
殃	yangDP
洋	yangE
泱	yangEC
漾	yangEP
瀁	yangEQ
阳	yangF
陽	yangFQ
紻	yangFS
阦	yangFT
颺	yangFU
飏	yangFV
鞅	yangG
秧	yangH
烊	yangHC
炀	yangHP
炴	yangHQ
煬	yangHS
样	yangI
杨	yangIP
楊	yangIQ
樣	yangIS
柍	yangIT
楧	yangIU
様	yangIV
卬	yangJQ
鉠	yangJS
鍈	yangJT
鍚	yangJU
钖	yangJV
锳	yangJW
劷	yangLQ
勜	yangLS
胦	yangLT
眏	yangMQ
眻	yangMS
駚	yangMT
鸯	yangN
鴦	yangNQ
姎	yangNS
婸	yangNT
鴹	yangNU
鸉	yangNV
咉	yangOQ
礢	yangPQ
氧	yangQ
氜	yangQQ
弇	yanGQR
氱	yangQS
旸	yangRQ
昜	yangRS
暘	yangRT
雵	yangRU
霷	yangRV
戭	yanGS
養	yangSQ
岟	yangSS
崵	yangST
崸	yangSU
禓	yangSV
飬	yangSW
坱	yangTQ
鬳	yanGTR
垟	yangTS
魘	yanGU
仰	yangV
佯	yangVP
佒	yangVQ
傟	yangVS
敭	yangWQ
玚	yangWS
珜	yangWT
瑒	yangWU
怏	yangX
恙	yangXP
愓	yangXQ
慃	yangXS
懩	yangXT
羊	yangY
詳	yangYQ
羏	yangYS
羕	yangYT
詇	yangYU
諹	yangYV
鰑	yangYW
严	yanH
炎	yanHC
燕	yanHD
焰	yanHE
焉	yanHF
焱	yanHG
爓	yanHI
燄	yanHJ
熖	yanHK
焔	yanHL
烻	yanHM
炏	yanHN
扊	yanHO
烟	yanHP
煙	yanHQ
黶	yanHS
黰	yanHT
黭	yanHU
黬	yanHV
黫	yanHW
黤	yanHX
黡	yanHY
虤	yanHZ
檐	yanI
欕	yanIO
櫩	yanIQ
梴	yanIS
棪	yanIT
椻	yanIU
椼	yanIV
楌	yanIW
樮	yanIX
橪	yanIY
檿	yanIZ
鉛	yanJQ
覎	yanJS
觃	yanJT
觾	yanJU
筵	yanK
篶	yanKQ
簷	yanKS
裺	yanKT
褗	yanKU
腌	yanL
胭	yanLP
鹽	yanLQ
臙	yanLS
麣	yanLT
龑	yanLU
眼	yanM
盐	yanMC
阎	yanMD
阉	yanME
阏	yanMF
闫	yanMG
验	yanMP
閻	yanMQ
驗	yanMS
驠	yanMT
閆	yanMU
閹	yanMV
閼	yanMW
騐	yanMX
験	yanMY
騴	yanMZ
嫣	yanN
嬮	yanNG
嬐	yanNH
嬊	yanNI
娮	yanNJ
娫	yanNK
姸	yanNL
姲	yanNM
妟	yanNN
嬿	yanNO
妍	yanNP
鷃	yanNQ
鷰	yanNS
鶠	yanNT
鴳	yanNU
鴈	yanNV
鳱	yanNW
鳫	yanNX
牪	yanNY
孍	yanNZ
咽	yanO
唁	yanOP
嚴	yanOQ
囐	yanOS
唌	yanOT
啱	yanOU
喦	yanOV
喭	yanOW
噞	yanOX
嚈	yanOY
嚥	yanOZ
鸦	yaNP
研	yanPA
砚	yanPC
殷	yanPP
硯	yanPQ
硏	yanPS
硽	yanPT
碞	yanPU
礹	yanPV
鴉	yaNQ
釅	yanQQ
酽	yanQR
歅	yanQS
狿	yanQT
猏	yanQU
猒	yanQV
酓	yanQW
醃	yanQX
醶	yanQY
醼	yanQZ
晏	yanR
昖	yanRQ
晻	yanRS
暥	yanRT
曕	yanRU
曣	yanRV
曮	yanRW
鴨	yaNS
岩	yanSA
彦	yanSC
鼹	yanSD
餍	yanSE
崦	yanSF
罨	yanSG
巗	yanSJ
巖	yanSK
巌	yanSL
嶖	yanSM
嵼	yanSN
嵓	yanSO
艳	yanSP
鼴	yanSQ
饜	yanSS
軅	yanST
躽	yanSU
彥	yanSV
巚	yanSW
巘	yanSX
嵃	yanSY
嵒	yanSZ
姶	yaNT
堰	yanTA
埏	yanTC
兖	yanTP
塩	yanTQ
墕	yanTS
壛	yanTT
壧	yanTU
婭	yaNU
芫	yanUP
莚	yanUQ
菸	yanUR
萒	yanUS
蔅	yanUT
鵶	yaNV
俨	yanVA
偃	yanVP
乵	yanVQ
偐	yanVS
傿	yanVT
儼	yanVU
琰	yanW
敥	yanWQ
珚	yanWS
琂	yanWT
甗	yanWU
恹	yanX
愝	yanXQ
懕	yanXS
懨	yanXT
窴	yanXU
言	yanY
颜	yanYC
谚	yanYD
谳	yanYE
讠	yanYM
讞	yanYN
讌	yanYO
延	yanYP
顏	yanYQ
諺	yanYS
鰋	yanYT
顩	yanYU
顔	yanYV
羬	yanYW
訁	yanYX
訮	yanYY
詽	yanYZ
雁	yanZ
趼	yanZP
艷	yanZQ
艶	yanZS
遃	yanZT
呀	yaO
摇	yaoA
搖	yaoAQ
抭	yaoAS
揺	yaoAT
摿	yaoAU
撽	yaoAV
瘧	yaoBQ
匋	yaoBS
宎	yaoBT
皐	yaoBU
鼼	yaoBV
徭	yaoC
轺	yaoCP
徺	yaoCQ
軺	yaoCS
齩	yaoCT
夭	yaoD
殀	yaoDQ
溔	yaoEQ
滧	yaoES
繇	yaoF
約	yaoFQ
纅	yaoFS
隃	yaoFT
颻	yaoFU
飖	yaoFV
靿	yaoGQ
烄	yaoHQ
烑	yaoHS
熎	yaoHT
燿	yaoHU
杳	yaoI
枖	yaoIQ
柼	yaoIS
楆	yaoIT
榚	yaoIU
榣	yaoIV
钥	yaoJ
铫	yaoJC
舀	yaoJP
覞	yaoJQ
銚	yaoJS
鎐	yaoJT
鑰	yaoJU
筄	yaoKQ
箹	yaoKS
袎	yaoKT
腰	yaoL
肴	yaoLP
麽	yaoM
眑	yaoMQ
矅	yaoMS
闄	yaoMT
騕	yaoMU
姚	yaoN
鹞	yaoNC
妖	yaoNP
婹	yaoNQ
媱	yaoNS
鴁	yaoNT
鴢	yaoNU
鷂	yaoNV
鷕	yaoNW
咬	yaoO
吆	yaoOP
喓	yaoOQ
嗂	yaoOS
哑	yaOP
爻	yaoPP
殽	yaoPQ
磘	yaoPS
啞	yaOQ
狕	yaoQQ
猺	yaoQS
獟	yaoQT
曜	yaoR
暚	yaoRQ
唖	yaOS
餚	yaoSQ
崾	yaoSR
岆	yaoSS
峣	yaoST
嶢	yaoSU
嶤	yaoSV
祅	yaoSW
餆	yaoSX
堯	yaoTQ
垚	yaoTS
药	yaoU
苭	yaoUQ
葯	yaoUS
葽	yaoUT
蓔	yaoUU
蕘	yaoUV
薬	yaoUW
藥	yaoUX
蘨	yaoUY
僥	yaoVQ
仸	yaoVS
倄	yaoVT
偠	yaoVU
傜	yaoVV
瑶	yaoW
珧	yaoWC
尧	yaoWP
瑤	yaoWQ
要	yaoX
窈	yaoXC
窑	yaoXP
窯	yaoXQ
怮	yaoXS
恌	yaoXT
愮	yaoXU
穾	yaoXV
窅	yaoXW
窔	yaoXX
窰	yaoXY
耀	yaoY
幺	yaoYC
鳐	yaoYD
谣	yaoYP
謠	yaoYQ
鱙	yaoYS
尭	yaoYT
訞	yaoYU
詏	yaoYV
謡	yaoYW
讑	yaoYX
顤	yaoYY
鰩	yaoYZ
遥	yaoZ
邀	yaoZP
遙	yaoZQ
艞	yaoZS
邎	yaoZT
砑	yaP
磍	yaPQ
氩	yaQ
氬	yaQQ
犽	yaQS
猚	yaQT
猰	yaQU
崖	yaS
岈	yaSP
崕	yaSQ
垭	yaT
壓	yaTQ
圠	yaTS
圧	yaTT
埡	yaTU
堐	yaTV
芽	yaU
蕥	yaUQ
伢	yaV
俹	yaVQ
琊	yaW
圔	yaWQ
玡	yaWS
瓛	yaWT
窫	yaXQ
襾	yaXS
覀	yaXT
牙	yaY
讶	yaYP
訝	yaYQ
雅	yaZ
迓	yaZP
孲	yaZQ
拽	yeA
揶	yeAC
揲	yeAD
掖	yeAP
抴	yeAQ
捓	yeAS
捙	yeAT
擖	yeAU
擛	yeAV
擨	yeAW
擪	yeAX
擫	yeAY
冶	yeB
痷	yeBQ
皣	yeBS
靥	yeC
蠮	yeCQ
殗	yeDQ
液	yeE
漜	yeEQ
潱	yeES
澲	yeET
爷	yeF
邺	yeFC
耶	yeFP
爺	yeFQ
緤	yeFS
鄴	yeFT
曳	yeG
烨	yeH
焆	yeHQ
煠	yeHS
燁	yeHT
爗	yeHU
椰	yeI
業	yeIQ
枼	yeIS
枽	yeIT
楪	yeIU
铘	yeJ
釾	yeJQ
鋣	yeJS
鍱	yeJT
鎁	yeJU
鎑	yeJV
鐷	yeJW
野	yeL
腋	yeLP
瞱	yeMQ
瞸	yeMS
靨	yeMT
驜	yeMU
鵺	yeNQ
鸈	yeNS
叶	yeO
噎	yeOP
吔	yeOQ
嘢	yeOS
嚥	yeOT
礏	yePQ
歋	yeQQ
晔	yeR
暍	yeRQ
曄	yeRS
曅	yeRT
曗	yeRU
曵	yeRV
峫	yeSQ
嶪	yeSS
嶫	yeST
餣	yeSU
饁	yeSV
馌	yeSW
亪	yeTQ
亱	yeTS
埜	yeTT
堨	yeTU
墷	yeTV
壄	yeTW
葉	yeUQ
也	yeV
倻	yeVQ
僷	yeVS
瑘	yeWQ
璍	yeWS
瓛	yeWT
夜	yeX
窫	yeXQ
业	yeY
谒	yeYC
页	yeYP
頁	yeYQ
謁	yeYS
抑	yiA
挹	yiAC
揖	yiAP
扡	yiAQ
拸	yiAS
掜	yiAT
撎	yiAU
疑	yiB
疫	yiBC
贻	yiBD
肄	yiBE
癔	yiBF
痍	yiBG
瘗	yiBH
瘞	yiBL
痬	yiBM
寲	yiBN
寱	yiBO
宜	yiBP
貽	yiBQ
贀	yiBS
賹	yiBT
貤	yiBU
瘱	yiBV
兿	yiBW
匇	yiBX
宐	yiBY
宧	yiBZ
役	yiC
蚁	yiCC
蜴	yiCD
轶	yiCE
螠	yiCK
螘	yiCL
螔	yiCM
蛦	yiCN
蛡	yiCO
蛇	yiCP
蟻	yiCQ
齸	yiCS
齮	yiCT
轙	yiCU
輢	yiCV
軼	yiCW
彵	yiCX
虵	yiCY
蛜	yiCZ
义	yiD
奕	yiDC
刈	yiDD
劓	yiDE
殪	yiDF
夷	yiDP
殔	yiDQ
已	yiE
漪	yiEC
沂	yiED
洂	yieEQ
浳	yiEL
浥	yiEM
浂	yiEN
洢	yiEO
溢	yiEP
瀷	yiEQ
澺	yiES
潩	yiET
湙	yiEU
渏	yiEV
巸	yiEW
沶	yiEX
泆	yiEY
洟	yiEZ
医	yiF
缢	yiFC
旖	yiFD
郼	yiFO
绎	yiFP
繹	yiFQ
阣	yiFS
鄓	yiFT
匜	yiFU
旑	yiFV
縊	yiFW
繄	yiFX
繶	yiFY
耴	yiFZ
异	yiG
弈	yiGC
彝	yiGP
庡	yiGQ
廙	yiGS
弬	yiGT
骮	yiGU
一	yiH
熠	yiHC
黟	yiHD
熪	yiHH
熤	yiHI
煕	yiHJ
焲	yiHK
焬	yiHL
炈	yiHM
扆	yiHN
扅	yiHO
移	yiHP
黳	yiHQ
黓	yiHS
穓	yiHT
稦	yiHU
秇	yiHV
燱	yiHW
燡	yiHX
燚	yiHY
熼	yiHZ
椅	yiI
栺	yiIH
栧	yiII
栘	yiIJ
柂	yiIK
枻	yiIL
枍	yiIM
杝	yiIN
杙	yiIO
檹	yiIQ
檥	yiIS
檍	yiIT
槸	yiIU
榏	yiIV
椸	yiIW
椬	yiIX
棭	yiIY
桋	yiIZ
铱	yiJ
镒	yiJC
镱	yiJD
鈘	yiJK
釶	yiJL
釴	yiJM
釔	yiJN
觺	yiJO
钇	yiJP
鐿	yiJQ
鏔	yiJS
鎰	yiJT
銥	yiJU
鉯	yiJV
鈠	yiJW
帟	yiJX
帠	yiJY
幆	yiJZ
衣	yiK
邑	yiKC
袣	yiKL
袘	yiKM
衪	yiKN
籎	yiKO
裔	yiKP
衤	yiKQ
襼	yiKS
褹	yiKT
裿	yiKU
裛	yiKV
笖	yiKW
箷	yiKX
篒	yiKY
簃	yiKZ
胰	yiL
翊	yiLC
臆	yiLP
劮	yiLQ
勚	yiLS
勩	yiLT
竩	yiLU
肊	yiLV
膉	yiLW
益	yiM
眙	yiMC
驿	yiMP
冝	yiMQ
睪	yiMS
瞖	yiMT
駅	yiMU
驛	yiMV
姨	yiN
寅	yinB
瘾	yinBP
癮	yinBQ
凐	yinBS
瘖	yinBT
癊	yinBU
蚓	yinC
龈	yinCP
螾	yinCQ
蟫	yinCS
輑	yinCT
齗	yinCU
齦	yinCV
龂	yinCW
殥	yinDQ
淫	yinE
洇	yinEP
泿	yinEQ
洕	yinES
淾	yinET
湚	yinEU
溵	yinEV
滛	yinEW
濥	yinEX
濦	yinEY
阴	yinF
鄞	yinFC
隐	yinFP
隱	yinFQ
陰	yinFS
絪	yinFT
緸	yinFU
縯	yinFV
阥	yinFW
陻	yinFX
隂	yinFY
隠	yinFZ
引	yinG
撄	yingA
摬	yingAQ
攍	yingAS
攖	yingAT
赢	yingB
瘿	yingBP
贏	yingBQ
癭	yingBS
賏	yingBT
蝇	yingC
螢	yingCQ
蠅	yingCS
蛍	yingCT
蝧	yingCU
蝿	yingCV
蠳	yingCW
瀛	yingE
潆	yingEC
濚	yingEJ
濙	yingEK
潁	yingEL
滎	yingEM
溋	yingEN
溁	yingEO
滢	yingEP
灜	yingEQ
灐	yingES
瀴	yingET
瀯	yingEU
瀠	yingEV
瀅	yingEW
濴	yingEX
浧	yingEY
渶	yingEZ
缨	yingF
郢	yingFC
罂	yingFP
緓	yingFQ
縈	yingFS
纓	yingFT
绬	yingFU
罃	yingFV
罌	yingFW
耺	yingFX
应	yingG
膺	yingGP
廮	yingGQ
鞕	yingGS
熒	yingHQ
營	yingHS
穎	yingHT
焸	yingHU
焽	yingHV
煐	yingHW
爃	yingHX
樱	yingI
楹	yingIP
櫻	yingIQ
柍	yingIS
桜	yingIT
桯	yingIU
梬	yingIV
楧	yingIW
櫿	yingIX
覮	yingJQ
鎣	yingJS
鐛	yingJT
鑍	yingJU
锳	yingJV
籝	yingKQ
籯	yingKS
褮	yingKT
媵	yingL
朠	yingLQ
膡	yingLS
盈	yingM
盁	yingMQ
眏	yingMS
婴	yingN
鹦	yingNC
鶧	yingNM
鶑	yingNN
鴬	yingNO
鹰	yingNP
鸚	yingNQ
鷹	yingNS
嬰	yingNT
鶯	yingNU
鸎	yingNV
鷪	yingNW
媖	yingNX
嫈	yingNY
孆	yingNZ
嘤	yingO
啨	yingOQ
営	yingOS
噟	yingOT
嚶	yingOU
硬	yingP
碤	yingPQ
礯	yingPS
廕	yinGQR
映	yingR
旲	yingRQ
暎	yingRS
霙	yingRT
影	yingS
嵤	yingSQ
靷	yinGSR
巆	yingSS
巊	yingST
矨	yingSU
禜	yingSV
軈	yingSW
嬴	yingT
塋	yingTQ
鞇	yinGTR
英	yingU
荧	yingUC
莹	yingUD
莺	yingUE
萤	yingUF
萦	yingUG
荥	yingUH
茔	yingUI
蓥	yingUJ
营	yingUP
萾	yingUQ
藀	yingUS
蘡	yingUT
偀	yingVQ
僌	yingVS
瑛	yingW
璎	yingWP
瑩	yingWQ
珱	yingWS
瓔	yingWT
甇	yingWU
甖	yingWV
應	yingXQ
応	yingXS
愥	yingXT
颖	yingY
颍	yingYP
謍	yingYQ
譍	yingYS
譻	yingYT
韺	yingYU
頴	yingYV
颕	yingYW
鱦	yingYX
迎	yingZ
夃	yingZQ
孾	yingZS
烎	yinHQ
秵	yinHS
栶	yinIQ
梀	yinIS
檃	yinIT
檭	yinIU
檼	yinIV
櫽	yinIW
印	yinJ
铟	yinJC
银	yinJP
銀	yinJQ
斦	yinJS
鈏	yinJT
鈝	yinJU
銦	yinJV
筃	yinKQ
裀	yinKS
冘	yinMQ
粌	yinMS
闇	yinMT
闉	yinMU
駰	yinMV
骃	yinMW
姻	yinN
婣	yinNQ
婬	yinNS
鷣	yinNT
吟	yinO
吲	yinOC
喑	yinOP
唫	yinOQ
噖	yinOS
噾	yinOT
嚚	yinOU
殷	yinP
胤	yinPP
乑	yinPQ
硍	yinPS
碒	yinPT
磤	yinPU
氤	yinQ
狺	yinQP
欭	yinQQ
歅	yinQS
犾	yinQT
猌	yinQU
酳	yinQV
霪	yinR
朄	yinRQ
霒	yinRS
霠	yinRT
饮	yinS
飲	yinSQ
岃	yinSS
峾	yinST
崟	yinSU
崯	yinSV
嶾	yinSW
禋	yinSX
飮	yinSY
垠	yinT
堙	yinTP
垔	yinTQ
垽	yinTS
堷	yinTT
荫	yinU
茚	yinUC
茵	yinUP
蔭	yinUQ
苂	yinUS
荶	yinUT
蒑	yinUU
蔩	yinUV
蘟	yinUW
鶍	yiNV
侌	yinVQ
因	yinW
囙	yinWQ
圁	yinWS
珢	yinWT
璌	yinWU
尹	yinX
夤	yinXC
窨	yinXP
愔	yinXQ
慇	yinXS
慭	yinXT
憖	yinXU
憗	yinXV
懚	yinXW
音	yinY
鮣	yinYQ
訔	yinYS
訚	yinYT
訡	yinYU
誾	yinYV
諲	yinYW
讔	yinYX
廴	yinYY
韾	yinYZ
赺	yinZQ
趛	yinZS
咦	yiO
呓	yiOC
噫	yiOD
嗌	yiOE
咿	yiOP
吚	yiOQ
呭	yiOS
呹	yiOT
唈	yiOU
囈	yiOV
毅	yiP
殹	yiPQ
毉	yiPS
礒	yiPT
欹	yiQ
酏	yiQC
豛	yiQM
豙	yiQN
獈	yiQO
猗	yiQP
醫	yiQQ
醷	yiQS
醳	yiQT
豷	yiQU
欥	yiQV
欭	yiQW
歝	yiQX
狋	yiQY
狏	yiQZ
易	yiR
昳	yiRQ
晹	yiRS
暆	yiRT
曀	yiRU
曎	yiRV
霬	yiRW
靉	yiRX
矣	yiS
壹	yiSC
峄	yiSD
饴	yiSE
嶷	yiSF
禕	yiSO
屹	yiSP
饐	yiSQ
飴	yiSS
壱	yiST
夁	yiSU
峓	yiSV
崺	yiSW
嶧	yiSX
嶬	yiSY
祎	yiSZ
亦	yiT
埸	yiTC
圯	yiTP
異	yiTQ
坄	yiTS
垼	yiTT
埶	yiTU
墿	yiTV
畩	yiTW
艺	yiU
苡	yiUC
荑	yiUD
薏	yiUE
藙	yiUO
艾	yiUP
藝	yiUQ
虉	yiUS
蘙	yiUT
芅	yiUU
苅	yiUV
苢	yiUW
萓	yiUX
萟	yiUY
蓺	yiUZ
以	yiV
仪	yiVC
伊	yiVD
乙	yiVE
亿	yiVF
倚	yiVG
佚	yiVH
佾	yiVI
偯	yiVO
依	yiVP
億	yiVQ
儀	yiVS
儗	yiVT
乚	yiVU
亄	yiVV
伇	yiVW
佁	yiVX
侇	yiVY
俋	yiVZ
珆	yiWO
瓵	yiWQ
瑿	yiWS
圛	yiWT
攺	yiWU
敡	yiWV
敧	yiWW
敼	yiWX
斁	yiWY
玴	yiWZ
意	yiX
怡	yiXC
悒	yiXD
怿	yiXE
悘	yiXM
恞	yiXN
怈	yiXO
忆	yiXP
憶	yiXQ
懝	yiXS
懌	yiXT
悥	yiXU
乂	yiXV
彛	yiXW
彜	yiXX
彞	yiXY
忔	yiXZ
议	yiY
翼	yiYC
谊	yiYD
翌	yiYE
颐	yiYF
诣	yiYG
弋	yiYH
懿	yiYI
羿	yiYJ
翳	yiYK
诒	yiYL
訲	yiYN
訑	yiYO
译	yiYP
義	yiYQ
詑	yiYS
詍	yiYT
訳	yiYU
叆	yiYV
叕	yiYW
弌	yiYX
羛	yiYY
羠	yiYZ
遗	yiZ
迤	yiZC
舣	yiZD
辷	yiZK
踦	yiZL
跠	yiZM
跇	yiZN
貖	yiZO
逸	yiZP
遺	yiZQ
隿	yiZS
逘	yiZT
迻	yiZU
迱	yiZV
迆	yiZW
攲	yiZX
艗	yiZY
艤	yiZZ
拥	yongA
擁	yongAQ
揘	yongAS
痈	yongB
癕	yongBQ
癰	yongBS
蛹	yongC
邕	yongCP
永	yongE
泳	yongEC
涌	yongEP
湧	yongEQ
滽	yongES
澭	yongET
灉	yongEU
郺	yongFQ
鄘	yongFS
庸	yongG
廱	yongGQ
柡	yongIQ
栐	yongIS
槦	yongIT
镛	yongJ
銿	yongJQ
鏞	yongJS
勇	yongL
臃	yongLP
勈	yongLQ
嫞	yongNQ
鷛	yongNS
咏	yongO
喁	yongOP
嗈	yongOQ
噰	yongOS
牅	yongPQ
牗	yongPS
砽	yongPT
硧	yongPU
醟	yongQQ
饔	yongS
嵱	yongSQ
彮	yongSS
雍	yongT
墉	yongTC
壅	yongTP
埇	yongTQ
塎	yongTS
苚	yongUQ
蒏	yongUS
佣	yongV
俑	yongVP
傭	yongVQ
恿	yongX
慵	yongXP
怺	yongXQ
悀	yongXS
惥	yongXT
愑	yongXU
愹	yongXV
慂	yongXW
用	yongY
鳙	yongYC
甬	yongYP
詠	yongYQ
顒	yongYS
颙	yongYT
鯒	yongYU
鰫	yongYV
鱅	yongYW
鲬	yongYX
踊	yongZ
踴	yongZQ
雝	yongZS
哟	yoO
唷	yoOP
喲	yoOQ
揂	youAQ
疣	youB
宥	youBC
卣	youBP
痏	youBQ
蚴	youC
蚰	youCC
蝤	youCD
蝣	youCE
釉	youCP
蜏	youCQ
輏	youCS
輶	youCT
油	youE
游	youEP
汼	youEQ
沋	youES
泑	youET
浟	youEU
湵	youEV
滺	youEW
瀀	youEX
邮	youF
繇	youFP
郵	youFQ
斿	youFS
纋	youFT
聈	youFU
鄾	youFV
庮	youGQ
黝	youH
丣	youHQ
秞	youHS
柚	youI
栯	youIQ
梄	youIS
梎	youIT
楢	youIU
槱	youIV
櫌	youIW
櫾	youIX
铀	youJ
铕	youJP
鈾	youJQ
銪	youJS
褎	youKQ
褏	youKS
有	youL
耰	youLQ
肬	youLS
麀	youLT
冘	youMQ
駀	youMS
妋	youNQ
姷	youNS
牰	youNT
右	youO
呦	youOP
哊	youOQ
唀	youOS
嚘	youOT
牖	youP
牗	youPQ
犹	youQ
猷	youQC
酉	youQP
猶	youQQ
狖	youQS
獶	youQT
獿	youQU
酭	youQV
幽	youS
鼬	youSP
峟	youSQ
峳	youSS
祐	youST
禉	youSU
由	youT
亴	youTQ
甴	youTS
莠	youU
莸	youUC
莜	youUP
苃	youUQ
莤	youUS
蕕	youUT
优	youV
攸	youVC
侑	youVD
佑	youVP
優	youVQ
偤	youVS
囿	youW
忧	youX
悠	youXP
憂	youXQ
怞	youXS
怣	youXT
怮	youXU
懮	youXV
又	youY
幼	youYC
尤	youYD
诱	youYE
鱿	youYF
尢	youYG
友	youYP
誘	youYQ
羑	youYS
羪	youYT
訧	youYU
魷	youYV
鮋	youYW
鲉	youYX
孧	youZQ
貁	youZS
迶	youZT
逌	youZU
逰	youZV
遊	youZW
邎	youZX
揄	yuA
援	yuanA
掾	yuanAP
寃	yuanBQ
貟	yuanBS
贠	yuanBT
原	yuanC
螈	yuanCC
辕	yuanCP
厡	yuanCQ
厵	yuanCS
蚖	yuanCT
蜎	yuanCU
蜵	yuanCV
蝝	yuanCW
蝯	yuanCX
轅	yuanCY
剈	yuanDQ
源	yuanE
沅	yuanEC
渊	yuanEP
淵	yuanEQ
涴	yuanES
渁	yuanET
渆	yuanEU
渕	yuanEV
湲	yuanEW
溒	yuanEX
灁	yuanEY
院	yuanF
缘	yuanFP
緣	yuanFQ
縁	yuanFS
邧	yuanFT
弲	yuanGQ
鼘	yuanGS
鼝	yuanGT
元	yuanH
橼	yuanI
杬	yuanIQ
棩	yuanIS
楥	yuanIT
榞	yuanIU
榬	yuanIV
櫞	yuanIW
鋺	yuanJQ
鎱	yuanJS
鈨	yuanJT
箢	yuanK
笎	yuanKQ
裫	yuanKS
裷	yuanKT
褑	yuanKU
褤	yuanKV
肙	yuanLQ
冤	yuanM
眢	yuanMC
鼋	yuanMP
盶	yuanMQ
駌	yuanMS
騵	yuanMT
黿	yuanMU
媛	yuanN
鸢	yuanNC
鵷	yuanNN
鳶	yuanNO
鸳	yuanNP
鴛	yuanNQ
鹓	yuanNS
鶰	yuanNT
鶢	yuanNU
妧	yuanNV
妴	yuanNW
媴	yuanNX
嫄	yuanNY
嬽	yuanNZ
员	yuanO
員	yuanOQ
喛	yuanOS
噮	yuanOT
猿	yuanQ
猨	yuanQQ
酛	yuanQS
禐	yuanSQ
袁	yuanT
塬	yuanTC
垸	yuanTD
垣	yuanTP
円	yuanTQ
苑	yuanU
芫	yuanUP
茒	yuanUQ
葾	yuanUS
蒝	yuanUT
蒬	yuanUU
薗	yuanUV
薳	yuanUW
傆	yuanVQ
圆	yuanW
圜	yuanWC
瑗	yuanWD
园	yuanWP
園	yuanWQ
圓	yuanWS
囦	yuanWT
圎	yuanWU
愿	yuanX
怨	yuanXP
夗	yuanXQ
悁	yuanXS
惌	yuanXT
衏	yuanXU
願	yuanYQ
羱	yuanYS
謜	yuanYT
魭	yuanYU
远	yuanZ
爰	yuanZP
遠	yuanZQ
逺	yuanZS
邍	yuanZT
扜	yuAQ
扝	yuAS
扵	yuAT
挧	yuAU
捓	yuAV
捥	yuAW
宇	yuB
舆	yuBC
瘀	yuBD
瘐	yuBE
寓	yuBP
寙	yuBQ
痏	yuBS
瘉	yuBT
癒	yuBU
御	yuC
龉	yuCC
蝓	yuCD
蜮	yuCE
尉	yuCP
輿	yuCQ
虶	yuCS
蜟	yuCT
螸	yuCU
輍	yuCV
轝	yuCW
齬	yuCX
齵	yuCY
奧	yuDQ
斞	yuDS
渔	yuE
扚	yueAQ
抈	yueAS
捳	yueAT
擽	yueAU
髺	yueBQ
淤	yuEC
蚎	yueCQ
蚏	yueCS
軏	yueCT
渝	yuED
瀹	yueE
兌	yueEQ
兊	yueES
泧	yueET
约	yueF
約	yueFQ
戉	yueGQ
湡	yuEH
爚	yueHQ
黦	yueHS
栎	yueI
樾	yueIP
樂	yueIQ
枂	yueIS
楽	yueIT
櫟	yueIU
钥	yueJ
钺	yueJP
鑰	yueJQ
鈅	yueJS
鉞	yueJT
潏	yuEK
箹	yueKQ
篗	yueKS
籆	yueKT
籥	yueKU
籰	yueKV
月	yueL
刖	yueLP
臒	yueLQ
阅	yueM
粤	yueMP
粵	yueMQ
閱	yueMS
矆	yueMT
閲	yueMU
灪	yuEN
妜	yueNQ
嬳	yueNS
鸑	yueNT
鸙	yueNU
澞	yuEO
哾	yueOQ
哕	yueOR
啘	yueOS
噦	yueOT
浴	yuEP
乐	yuePA
漁	yuEQ
曰	yueR
曱	yueRQ
岳	yueS
岄	yueSQ
嶽	yueSS
矱	yueST
礿	yueSU
禴	yueSV
澦	yuET
亐	yuEU
藥	yueUQ
蘥	yueUS
淢	yuEV
龠	yueVR
淯	yuEW
玥	yueWQ
悦	yueX
悅	yueXQ
恱	yueXS
滪	yuEY
说	yueYA
說	yueYQ
説	yueYS
越	yueZ
跃	yueZP
躍	yueZQ
趯	yueZS
跀	yueZT
郁	yuF
隅	yuFC
纡	yuFD
旕	yuFO
於	yuFP
隩	yuFQ
匬	yuFS
旟	yuFT
紆	yuFU
緎	yuFV
邘	yuFW
鄅	yuFX
陓	yuFY
隃	yuFZ
鬻	yuG
庾	yuGP
庽	yuGQ
戫	yuGS
骬	yuGT
髃	yuGU
魊	yuGV
于	yuH
虞	yuHC
熨	yuHD
煜	yuHE
燠	yuHF
稶	yuHO
与	yuHP
穥	yuHQ
穀	yuHS
丂	yuHT
灹	yuHU
焴	yuHV
燏	yuHW
爩	yuHX
秗	yuHY
稢	yuHZ
榆	yuI
楡	yuIM
楀	yuIN
棫	yuIO
欝	yuIQ
欎	yuIS
櫲	yuIT
楰	yuIU
杅	yuIV
栯	yuIW
桙	yuIX
棛	yuIY
棜	yuIZ
臾	yuJ
觎	yuJC
舁	yuJD
錥	yuJN
鋙	yuJO
钰	yuJP
與	yuJQ
铻	yuJS
鐭	yuJT
鍝	yuJU
覦	yuJV
釪	yuJW
鈺	yuJX
銉	yuJY
鋊	yuJZ
裕	yuK
竽	yuKP
箊	yuKQ
篽	yuKS
籅	yuKT
籞	yuKU
籲	yuKV
衧	yuKW
袬	yuKX
褕	yuKY
育	yuL
腴	yuLC
禺	yuLP
麌	yuLQ
粥	yuM
阈	yuMC
盂	yuMD
驭	yuMP
盓	yuMQ
睮	yuMS
矞	yuMT
粖	yuMU
閾	yuMV
馭	yuMW
騟	yuMX
驈	yuMY
娱	yuN
云	yunA
抎	yunAQ
抣	yunAS
匀	yunB
勻	yunBQ
疺	yunBS
貟	yunBT
賱	yunBU
贇	yunBV
赟	yunBW
妪	yuNC
蝹	yunCQ
齫	yunCS
齳	yunCT
妤	yuND
夽	yunDQ
殒	yunDR
奫	yunDS
殞	yunDT
鹆	yuNE
允	yunEA
沄	yunEQ
涒	yunES
涢	yunET
溳	yunEU
澐	yunEV
陨	yunF
郓	yunFC
郧	yunFD
鄆	yunFN
耺	yunFO
纭	yunFP
隕	yunFQ
阭	yunFS
鄖	yunFT
紜	yunFU
緷	yunFV
緼	yunFW
縕	yunFX
縜	yunFY
缊	yunFZ
鴥	yuNG
鞰	yunGQ
嬩	yuNH
熨	yunHP
煇	yunHQ
煴	yunHS
煾	yunHT
熅	yunHU
熉	yunHV
秐	yunHW
嫗	yuNI
枟	yunIQ
榅	yunIS
橒	yunIT
媮	yuNJ
鈗	yunJQ
鋆	yunJS
媀	yuNK
筠	yunKA
筼	yunKQ
篔	yunKS
褞	yunKT
婾	yuNL
耘	yunLA
腪	yunLQ
娯	yuNM
眃	yunMQ
馻	yunMS
娪	yuNN
妘	yunNQ
媼	yunNS
鳿	yuNO
員	yunOQ
喗	yunOS
鹬	yuNP
磒	yunPQ
娛	yuNQ
狁	yunQC
氲	yunQP
醞	yunQQ
酝	yunQR
氳	yunQS
醖	yunQT
晕	yunR
昀	yunRP
暈	yunRQ
雲	yunRS
霣	yunRT
鸒	yuNS
餫	yunSQ
鸆	yuNT
畇	yunTQ
鷸	yuNU
蕴	yunUA
芸	yunUP
蘊	yunUQ
荺	yunUS
蒀	yunUT
蒕	yunUU
蒷	yunUV
蕓	yunUW
蕰	yunUX
薀	yunUY
藴	yunUZ
鷠	yuNV
伝	yunVQ
傊	yunVS
鵒	yuNW
韫	yunWA
囩	yunWQ
玧	yunWS
韗	yunWT
韞	yunWU
鴪	yuNX
恽	yunXA
愠	yunXP
惲	yunXQ
愪	yunXS
慍	yunXT
馧	yunXU
鴧	yuNY
韵	yunYA
韻	yunYQ
运	yunZ
孕	yunZP
運	yunZQ
喻	yuO
吁	yuOP
唹	yuOQ
喅	yuOS
喩	yuOT
噳	yuOU
禹	yuP
毓	yuPP
牏	yuPQ
砡	yuPS
硢	yuPT
硲	yuPU
礇	yuPV
礖	yuPW
礜	yuPX
欲	yuQ
欤	yuQC
狳	yuQD
狱	yuQP
獄	yuQQ
欥	yuQS
歈	yuQT
歟	yuQU
酑	yuQV
醧	yuQW
雨	yuR
昱	yuRC
雩	yuRP
兪	yuRQ
霱	yuRS
豫	yuS
峪	yuSC
馀	yuSD
嵛	yuSE
饫	yuSF
罭	yuSM
禦	yuSN
祤	yuSO
屿	yuSP
餘	yuSQ
嶼	yuSS
饇	yuST
飫	yuSU
軉	yuSV
崳	yuSW
嵎	yuSX
嶎	yuSY
彧	yuSZ
域	yuT
畲	yuTP
圫	yuTQ
堉	yuTS
堣	yuTT
堬	yuTU
畬	yuTV
芋	yuU
蓣	yuUC
蕍	yuUL
蓹	yuUM
蒮	yuUN
萮	yuUO
萸	yuUP
蘛	yuUQ
蘌	yuUS
藇	yuUT
薁	yuUU
蕷	yuUV
芌	yuUW
茟	yuUX
茰	yuUY
萭	yuUZ
余	yuV
俞	yuVC
伛	yuVD
俣	yuVE
予	yuVP
伃	yuVQ
俁	yuVS
俼	yuVT
偊	yuVU
傴	yuVV
僪	yuVW
儥	yuVX
玉	yuW
圄	yuWC
圉	yuWD
瑜	yuWP
敔	yuWQ
斔	yuWS
玗	yuWT
玙	yuWU
琙	yuWV
琟	yuWW
瑀	yuWX
璵	yuWY
愈	yuX
愚	yuXC
窬	yuXD
窳	yuXE
愉	yuXP
忬	yuXQ
悆	yuXS
惐	yuXT
慾	yuXU
懙	yuXV
穻	yuXW
语	yuY
预	yuYC
誉	yuYD
羽	yuYE
谕	yuYF
谀	yuYG
聿	yuYH
鯲	yuYI
謣	yuYJ
諭	yuYK
諛	yuYL
翑	yuYM
羭	yuYN
叞	yuYO
鱼	yuYP
魚	yuYQ
龥	yuYR
鬱	yuYS
預	yuYT
語	yuYU
譽	yuYV
魣	yuYW
鬰	yuYX
頨	yuYY
肀	yuYZ
遇	yuZ
迂	yuZC
遹	yuZO
逾	yuZP
雤	yuZQ
雓	yuZS
歶	yuZT
艅	yuZU
貐	yuZV
踰	yuZW
込	yuZX
迃	yuZY
逳	yuZZ
鮽	yvYQ
鰅	yvYS
鱊	yvYT
乁	yzNC
嬑	yzNE
嬄	yzNF
嫛	yzNG
嫕	yzNH
媐	yzNI
妷	yzNJ
嬟	yzNK
鳦	yzNL
鴺	yzNM
鶂	yzNN
鶃	yzNO
鷧	yzNQ
鹥	yzNS
鹢	yzNT
鹝	yzNU
鸃	yzNV
鷾	yzNW
鷖	yzNX
鷊	yzNY
鷁	yzNZ
譩	yzYG
謻	yzYH
誃	yzYI
詣	yzYJ
詒	yzYK
讉	yzYL
讛	yzYM
頉	yzYN
頤	yzYO
誼	yzYQ
譯	yzYS
議	yzYT
鯣	yzYU
鮨	yzYV
鮧	yzYW
顗	yzYX
顊	yzYY
頥	yzYZ
拶	zaA
沞	zaEQ
沯	zaES
匝	zaF
紥	zaFQ
紮	zaFS
杂	zaI
扗	zaiAQ
抂	zaiAS
宰	zaiB
賳	zaiBQ
载	zaiC
甾	zaiCP
載	zaiCQ
洅	zaiEQ
渽	zaiES
溨	zaiET
縡	zaiFQ
灾	zaiH
災	zaiHQ
烖	zaiHS
栽	zaiI
睵	zaiMQ
哉	zaiO
桚	zaIQ
酨	zaiQQ
崽	zaiS
岾	zaiSQ
在	zaiT
再	zaiTP
畠	zaiTQ
橴	zaIU
菑	zaiUQ
傤	zaiVQ
儎	zaiVS
子	zaiZ
帀	zaJQ
鉔	zaJS
襍	zaKQ
臜	zaLQ
臢	zaLS
攒	zanA
撍	zanAQ
揝	zanAQR
撍	zanAS
攅	zanAT
攢	zanAU
赞	zanB
贊	zanBQ
寁	zanBS
賛	zanBT
兂	zanEQ
濽	zanES
灒	zanET
鄼	zanFQ
酂	zanFS
酇	zanFT
赃	zangB
贓	zangBQ
賍	zangBS
賘	zangBT
贜	zangBU
奘	zangD
匨	zangFQ
臧	zangG
弉	zangGQ
髒	zangGS
欌	zangIQ
銺	zangJQ
脏	zangL
臟	zangLQ
臓	zangLS
驵	zangM
駔	zangMQ
牂	zangPQ
塟	zangTQ
葬	zangU
蔵	zangUQ
羘	zangYQ
穳	zanHQ
桚	zanIQ
橵	zanIS
錾	zanJ
鏨	zanJQ
鏩	zanJS
鐕	zanJT
鐟	zanJU
簪	zanK
篸	zanKQ
簮	zanKS
襸	zanKT
糌	zanM
鵤	zanNQ
咱	zanO
喒	zanOQ
噆	zanOS
囋	zanOT
暂	zanR
昝	zanRP
暫	zanRQ
禶	zanSQ
饡	zanSS
塹	zanTQ
偺	zanVQ
儧	zanVS
儹	zanVT
瓒	zanW
瓉	zanWQ
瓚	zanWS
怎	zanX
谮	zanY
讚	zanYQ
譖	zanYQR
讃	zanYS
趱	zanZ
趲	zanZQ
蹔	zanZS
咋	zaO
皂	zaoB
皁	zaoBQ
蚤	zaoC
澡	zaoE
燥	zaoH
灶	zaoHP
煰	zaoHQ
枣	zaoI
棗	zaoIQ
栆	zaoIS
梍	zaoIT
鑿	zaoJQ
凿	zaoK
簉	zaoKQ
糟	zaoM
噪	zaoO
唣	zaoOP
唕	zaoOQ
喿	zaoOS
咂	zaOP
喒	zaOQ
醩	zaoQQ
早	zaoR
噈	zaOS
囃	zaOT
藻	zaoU
薻	zaoUQ
囐	zaOV
傮	zaoVQ
璅	zaoWQ
璪	zaoWS
囋	zaOX
竈	zaoXQ
慥	zaoXS
竃	zaoXT
謲	zaoYQ
譟	zaoYS
造	zaoZ
躁	zaoZC
遭	zaoZP
艁	zaoZQ
趮	zaoZS
蹧	zaoZT
砸	zaP
偺	zaVQ
韴	zaYQ
魳	zaYS
雜	zaZQ
雑	zaZS
雥	zaZT
择	zeA
擇	zeAQ
択	zeAS
捑	zeAT
责	zeB
責	zeBQ
皟	zeBS
賾	zeBT
仄	zeC
蠌	zeCQ
齚	zeCS
齰	zeCT
则	zeD
則	zeDQ
泽	zeE
澤	zeEQ
汄	zeES
沢	zeET
泎	zeEU
溭	zeEV
滜	zeEW
灂	zeEX
赜	zeF
庂	zeGQ
稄	zeHQ
贼	zeiB
賊	zeiBQ
蠈	zeiCQ
戝	zeiGQ
樍	zeIQ
鰂	zeiYQ
鱡	zeiYS
鲗	zeiYT
帻	zeJ
幘	zeJQ
笮	zeK
箦	zeKP
簀	zeKQ
襗	zeKS
耫	zeLQ
睪	zeMQ
瞔	zeMS
矠	zeMT
赠	zengB
贈	zengBQ
缯	zengFP
綜	zengFQ
縡	zengFS
繒	zengFT
鄫	zengFU
鬵	zengGQ
熷	zengHQ
橧	zengIQ
锃	zengJ
鋥	zengJQ
竲	zengLQ
囎	zengOQ
磳	zengPQ
曽	zengRQ
罾	zengS
矰	zengSQ
增	zengT
増	zengTQ
甑	zengW
璔	zengWQ
憎	zengX
譄	zengYQ
鱛	zengYS
嫧	zeNQ
鸅	zeNS
咋	zeO
啧	zeOP
唶	zeOQ
啫	zeOS
嘖	zeOT
礋	zePQ
昃	zeR
昗	zeRQ
崱	zeSQ
飵	zeSS
蔶	zeUQ
側	zeVQ
諎	zeYQ
謮	zeYS
迮	zeZ
舴	zeZP
歵	zeZQ
扎	zhaA
揸	zhaAP
抯	zhaAQ
拃	zhaAS
挓	zhaAT
搾	zhaAU
摣	zhaAV
齄	zhaB
痄	zhaBP
宱	zhaBQ
齇	zhaBS
轧	zhaC
蚱	zhaCP
蠟	zhaCQ
厏	zhaCS
蚻	zhaCT
軋	zhaCU
剳	zhaDQ
劄	zhaDS
奓	zhaDT
渣	zhaE
溠	zhaEQ
潳	zhaES
紥	zhaFQ
紮	zhaFS
炸	zhaH
灹	zhaHQ
煠	zhaHS
榨	zhaI
摘	zhaiA
択	zhaiAQ
抧	zhaiAS
捚	zhaiAT
擇	zhaiAU
擿	zhaiAV
寨	zhaiB
瘵	zhaiBC
宅	zhaiBP
責	zhaiBQ
札	zhaIC
厇	zhaiCQ
厏	zhaiCS
楂	zhaID
柞	zhaIE
亝	zhaiEQ
榸	zhaiIQ
檡	zhaiIS
鉙	zhaiJQ
粂	zhaiMQ
嚌	zhaiOQ
栅	zhaIP
砦	zhaiPR
柵	zhaIQ
齋	zhaiQQ
柤	zhaIS
査	zhaIT
樝	zhaIU
债	zhaiV
債	zhaiVQ
側	zhaiVS
斋	zhaiW
斎	zhaiWQ
窄	zhaiX
翟	zhaiY
夈	zhaiZQ
铡	zhaJ
觰	zhaJQ
鍘	zhaJS
箚	zhaKQ
耫	zhaLQ
眨	zhaM
闸	zhaMP
閘	zhaMQ
搌	zhanA
占	zhanB
辗	zhanC
輾	zhanCQ
蛅	zhanCS
輚	zhanCT
轏	zhanCU
沾	zhanE
湛	zhanEP
绽	zhanF
旃	zhanFP
綻	zhanFQ
旜	zhanFS
颭	zhanFT
飐	zhanFU
战	zhanG
掌	zhangA
扙	zhangAQ
账	zhangB
瘴	zhangBP
長	zhangBQ
賬	zhangBS
痮	zhangBT
瘬	zhangBU
长	zhangC
蟑	zhangCP
涨	zhangE
漳	zhangEP
漲	zhangEQ
兏	zhangES
涱	zhangET
障	zhangF
鄣	zhangFP
张	zhangG
張	zhangGQ
弡	zhangGS
鞝	zhangGT
丈	zhangH
杖	zhangI
樟	zhangIP
帐	zhangJ
幛	zhangJP
帳	zhangJQ
幥	zhangJS
鏱	zhangJT
章	zhangL
胀	zhangLP
脹	zhangLQ
麞	zhangLS
瞕	zhangMQ
粀	zhangMS
粻	zhangMT
騿	zhangMU
嫜	zhangN
礃	zhangPQ
獐	zhangQ
戰	zhanGQR
暲	zhangRQ
彰	zhangS
嶂	zhangSP
餦	zhangSQ
戦	zhanGSR
魙	zhanGT
墇	zhangTQ
蔁	zhangUQ
仗	zhangV
仉	zhangVP
仧	zhangVQ
傽	zhangVS
璋	zhangW
慞	zhangXQ
鱆	zhangYQ
遧	zhangZQ
虥	zhanHQ
虦	zhanHS
黵	zhanHT
栈	zhanI
棧	zhanIQ
枬	zhanIS
栴	zhanIT
桟	zhanIU
榐	zhanIV
橏	zhanIW
欃	zhanIX
斩	zhanJ
斬	zhanJQ
覱	zhanJS
襢	zhanKQ
站	zhanL
粘	zhanM
毡	zhanMC
瞻	zhanMD
盏	zhanMP
氈	zhanMQ
盞	zhanMS
氊	zhanMT
閚	zhanMU
驏	zhanMV
驙	zhanMW
嫸	zhanNQ
鳽	zhanNS
鸇	zhanNT
鹯	zhanNU
噡	zhanOQ
展	zhanP
皽	zhanPQ
碊	zhanPS
醆	zhanQQ
霑	zhanRQ
崭	zhanS
嵁	zhanSQ
嶃	zhanSS
嶄	zhanST
嶘	zhanSU
嶦	zhanSV
飦	zhanSW
饘	zhanSX
蘸	zhanU
菚	zhanUQ
薝	zhanUS
佔	zhanVQ
偡	zhanVS
僝	zhanVT
琖	zhanWQ
怗	zhanXQ
惉	zhanXS
詹	zhanY
谵	zhanYP
詀	zhanYQ
譧	zhanYS
譫	zhanYT
讝	zhanYU
顫	zhanYV
鱣	zhanYW
鳣	zhanYX
趈	zhanZQ
邅	zhanZS
咋	zhaO
找	zhaoA
招	zhaoAP
咤	zhaOC
吒	zhaODR
兆	zhaoE
沼	zhaoEP
巶	zhaoEQ
哳	zhaOER
旐	zhaoFQ
罀	zhaoFS
照	zhaoH
炤	zhaoHQ
燳	zhaoHS
棹	zhaoI
枛	zhaoIQ
櫂	zhaoIS
钊	zhaoJ
釗	zhaoJQ
釽	zhaoJS
鉊	zhaoJT
鍣	zhaoJU
笊	zhaoK
箌	zhaoKQ
朝	zhaoL
着	zhaoM
瞾	zhaoMQ
駋	zhaoMS
鼂	zhaoMT
鼌	zhaoMU
妱	zhaoNQ
鳭	zhaoNS
召	zhaoO
啅	zhaoOQ
喳	zhaOP
皽	zhaoPQ
啑	zhaOQ
狣	zhaoQQ
昭	zhaoR
曌	zhaoRQ
罩	zhaoS
羄	zhaoSQ
喥	zhaOSR
垗	zhaoTQ
菬	zhaoUQ
佋	zhaoVQ
瑵	zhaoWQ
诏	zhaoY
肇	zhaoYP
肁	zhaoYQ
肈	zhaoYS
詔	zhaoYT
謿	zhaoYU
鮡	zhaoYV
赵	zhaoZ
爪	zhaoZP
趙	zhaoZQ
爫	zhaoZS
乍	zhaP
砟	zhaPP
牐	zhaPQ
皶	zhaPS
皻	zhaPT
醡	zhaQQ
霅	zhaRQ
栅	zhaS
飵	zhaSQ
苲	zhaUQ
偧	zhaVQ
诈	zhaY
詐	zhaYQ
諎	zhaYS
譇	zhaYT
譗	zhaYU
鮓	zhaYV
鮺	zhaYW
鲊	zhaYX
鲝	zhaYY
折	zheA
摺	zheAP
扸	zheAQ
搩	zheAS
辙	zheC
蛰	zheCC
蜇	zheCD
赭	zheCE
螫	zheCF
辄	zheCP
轍	zheCQ
厇	zheCS
虴	zheCT
蟄	zheCU
蟅	zheCV
輒	zheCW
輙	zheCX
歽	zheDQ
浙	zheE
淛	zheEQ
聑	zheFQ
柘	zheI
杔	zheIQ
棏	zheIS
樜	zheIT
這	zheiZQ
锗	zheJ
銸	zheJQ
鍺	zheJS
褶	zheK
袩	zheKQ
襵	zheKS
者	zheL
着	zheM
籷	zheMQ
粍	zheMS
馲	zheMT
鹧	zheN
振	zhenA
抮	zhenAQ
挋	zhenAS
揕	zhenAT
搸	zhenAU
贞	zhenB
赈	zhenBC
疹	zhenBP
貞	zhenBQ
寊	zhenBS
賑	zhenBT
鬒	zhenBU
轸	zhenC
軫	zhenCQ
轃	zhenCS
辴	zhenCT
斟	zhenD
殝	zhenDQ
浈	zhenE
湞	zhenEQ
潧	zhenES
澵	zhenET
阵	zhenF
缜	zhenFP
陣	zhenFQ
紖	zhenFS
紾	zhenFT
絼	zhenFU
縝	zhenFV
縥	zhenFW
纼	zhenFX
聄	zhenFY
拯	zhengAC
挣	zhengAP
掙	zhengAQ
抍	zhengAS
掟	zhengAT
揁	zhengAU
撜	zhengAV
症	zhengB
癥	zhengBQ
鬇	zhengBS
征	zhengC
徵	zhengCP
徎	zhengCQ
徰	zhengCS
徴	zhengCT
争	zhengD
氶	zhengEQ
郑	zhengF
鄭	zhengFQ
糽	zhengFS
綪	zhengFT
聇	zhengFU
炡	zhengHQ
烝	zhengHS
铮	zhengJ
钲	zhengJP
幁	zhengJQ
鉦	zhengJS
錚	zhengJT
鏳	zhengJU
凧	zhengJV
筝	zhengK
箏	zhengKQ
篜	zhengKS
脀	zhengLQ
睁	zhengM
睜	zhengMQ
眐	zhengMS
姃	zhengNQ
媜	zhengNS
鴊	zhengNT
弫	zhenGQ
猙	zhengQQ
狰	zhengQR
靕	zhengQS
晸	zhengRQ
峥	zhengS
崝	zhengSQ
崢	zhengSS
埥	zhengTQ
埩	zhengTS
塣	zhengTT
蒸	zhengU
佂	zhengVQ
政	zhengW
整	zhengWP
怔	zhengX
愸	zhengXQ
憕	zhengXS
证	zhengY
诤	zhengYP
證	zhengYQ
証	zhengYS
諍	zhengYT
鯖	zhengYU
正	zhengZ
爭	zhengZQ
踭	zhengZS
臻	zhenH
稹	zhenHP
黰	zhenHQ
枕	zhenI
榛	zhenIC
椹	zhenID
桢	zhenIP
枮	zhenIQ
栚	zhenIS
桭	zhenIT
楨	zhenIU
榐	zhenIV
槙	zhenIW
樼	zhenIX
针	zhenJ
帧	zhenJC
鍼	zhenJO
镇	zhenJP
鎮	zhenJQ
針	zhenJS
鎭	zhenJT
帪	zhenJU
幀	zhenJV
覙	zhenJW
鉁	zhenJX
鋴	zhenJY
錱	zhenJZ
箴	zhenK
籈	zhenKQ
袗	zhenKS
裖	zhenKT
朕	zhenL
胗	zhenLP
竧	zhenLQ
眕	zhenMQ
眞	zhenMS
眹	zhenMT
駗	zhenMU
鸩	zhenN
姫	zhenNQ
嫃	zhenNS
鴆	zhenNT
砧	zhenP
屒	zhenPQ
碪	zhenPS
嫬	zheNQ
獉	zhenQQ
酙	zhenQS
震	zhenR
昣	zhenRQ
真	zhenS
祯	zhenSP
禎	zhenSQ
鷓	zheNSR
禛	zhenSS
圳	zhenT
畛	zhenTP
塦	zhenTQ
甽	zhenTS
蓁	zhenU
葴	zhenUQ
蒖	zhenUS
薽	zhenUT
萙	zhenUU
侦	zhenV
偵	zhenVQ
侲	zhenVS
珍	zhenW
甄	zhenWP
珎	zhenWQ
瑧	zhenWS
瑱	zhenWT
诊	zhenY
診	zhenYQ
誫	zhenYS
鱵	zhenYT
遉	zhenZQ
哲	zheO
喆	zheOQ
啠	zheOS
嗻	zheOT
嚞	zheOU
乇	zheP
磔	zhePP
矺	zhePQ
砓	zhePS
晢	zheRQ
晣	zheRS
埑	zheTQ
蔗	zheU
悊	zheXQ
慹	zheXS
谪	zheY
詟	zheYQ
謫	zheYS
謺	zheYT
讁	zheYU
讋	zheYV
鮿	zheYW
乽	zheYX
这	zheZ
遮	zheZP
這	zheZQ
踷	zheZS
指	zhiA
挚	zhiAC
掷	zhiAD
摭	zhiAE
摕	zhiAL
搱	zhiAM
搘	zhiAN
捗	zhiAO
执	zhiAP
擲	zhiAQ
摯	zhiAS
擿	zhiAT
擳	zhiAU
摨	zhiAV
扺	zhiAW
扻	zhiAX
抧	zhiAY
挃	zhiAZ
质	zhiB
痔	zhiBC
贽	zhiBD
痣	zhiBP
質	zhiBQ
贄	zhiBS
寘	zhiBT
巵	zhiBU
疷	zhiBV
疻	zhiBW
痓	zhiBX
瘈	zhiBY
貭	zhiBZ
蜘	zhiC
轵	zhiCC
轾	zhiCD
蛭	zhiCP
輊	zhiCQ
厔	zhiCS
徏	zhiCT
徝	zhiCU
徴	zhiCV
蚔	zhiCW
螲	zhiCX
蟙	zhiCY
軹	zhiCZ
之	zhiD
殖	zhiDC
制	zhiDP
剬	zhiDQ
劕	zhiDS
治	zhiE
汁	zhiEC
淽	zhiEK
淔	zhiEL
洷	zhiEM
洔	zhiEN
泜	zhiEO
滞	zhiEP
滯	zhiEQ
瀄	zhiES
潪	zhiET
潌	zhiEU
漐	zhiEV
滍	zhiEW
汥	zhiEX
汦	zhiEY
沚	zhiEZ
织	zhiF
纸	zhiFC
絷	zhiFD
郅	zhiFE
陟	zhiFF
縶	zhiFI
緻	zhiFJ
綕	zhiFK
絺	zhiFL
紩	zhiFM
旘	zhiFN
聀	zhiFO
职	zhiFP
職	zhiFQ
紙	zhiFS
織	zhiFT
隲	zhiFU
阯	zhiFV
酈	zhiFW
豒	zhiFX
豑	zhiFY
聜	zhiFZ
庢	zhiGQ
庤	zhiGS
廌	zhiGT
戠	zhiGU
瓡	zhiGV
秩	zhiH
炙	zhiHC
稚	zhiHP
穉	zhiHQ
熫	zhiHS
秇	zhiHT
秓	zhiHU
秖	zhiHV
秲	zhiHW
秷	zhiHX
稙	zhiHY
稺	zhiHZ
植	zhiI
桎	zhiIC
栉	zhiID
栀	zhiIE
枳	zhiIF
榰	zhiIM
楖	zhiIN
椥	zhiIO
枝	zhiIP
櫛	zhiIQ
櫍	zhiIS
樴	zhiIT
槯	zhiIU
杫	zhiIV
柣	zhiIW
栺	zhiIX
梔	zhiIY
梽	zhiIZ
帜	zhiJ
觯	zhiJC
凪	zhiJK
銍	zhiJL
釞	zhiJM
觶	zhiJN
觗	zhiJO
帙	zhiJP
幟	zhiJQ
锧	zhiJS
铚	zhiJT
鑕	zhiJU
鋕	zhiJV
銴	zhiJW
帋	zhiJX
斦	zhiJY
覟	zhiJZ
筫	zhiKQ
衹	zhiKS
衼	zhiKT
袟	zhiKU
袠	zhiKV
製	zhiKW
襧	zhiKX
脂	zhiL
胝	zhiLC
膣	zhiLD
肢	zhiLP
劧	zhiLQ
胑	zhiLS
膱	zhiLT
眰	zhiMQ
骘	zhiMR
馶	zhiMS
馽	zhiMT
駤	zhiMU
騭	zhiMV
騺	zhiMW
驇	zhiMX
鼅	zhiMY
鸷	zhiN
鴲	zhiNO
鷙	zhiNQ
鶨	zhiNS
妷	zhiNT
姪	zhiNU
娡	zhiNV
嬂	zhiNW
犆	zhiNX
鳷	zhiNY
鴙	zhiNZ
只	zhiO
吱	zhiOP
呮	zhiOQ
咫	zhiP
卮	zhiPP
砋	zhiPQ
礩	zhiPS
酯	zhiQA
狾	zhiQQ
猘	zhiQS
智	zhiR
旨	zhiRP
晊	zhiRQ
知	zhiS
置	zhiSC
峙	zhiSD
雉	zhiSE
祉	zhiSF
直	zhiSP
崻	zhiSQ
祇	zhiSS
祑	zhiST
祬	zhiSU
禃	zhiSV
禔	zhiSW
軄	zhiSX
址	zhiT
埴	zhiTP
執	zhiTQ
坁	zhiTS
坧	zhiTT
垁	zhiTU
墆	zhiTV
墌	zhiTW
畤	zhiTX
芝	zhiU
芷	zhiUP
芖	zhiUQ
茋	zhiUS
茝	zhiUT
菭	zhiUU
藢	zhiUV
蘵	zhiUW
值	zhiV
彘	zhiVC
侄	zhiVP
乿	zhiVQ
伿	zhiVS
俧	zhiVT
倁	zhiVU
値	zhiVV
偫	zhiVW
傂	zhiVX
儨	zhiVY
致	zhiW
璏	zhiWQ
瓆	zhiWS
志	zhiX
忮	zhiXC
窒	zhiXP
恉	zhiXQ
慹	zhiXS
憄	zhiXT
懥	zhiXU
懫	zhiXV
識	zhiYQ
黹	zhiYR
翐	zhiYS
訨	zhiYT
誌	zhiYU
鯯	zhiYV
至	zhiZ
止	zhiZC
趾	zhiZD
跖	zhiZE
踯	zhiZF
豸	zhiZG
踬	zhiZH
躑	zhiZM
蹢	zhiZN
蹠	zhiZO
支	zhiZP
雙	zhiZQ
隻	zhiZS
迣	zhiZT
躓	zhiZU
歭	zhiZV
疐	zhiZW
臷	zhiZX
臸	zhiZY
跱	zhiZZ
瘇	zhongBQ
螽	zhongC
彸	zhongCQ
徸	zhongCS
蚛	zhongCT
蜙	zhongCU
螤	zhongCV
刣	zhongDQ
汷	zhongEQ
泈	zhongES
终	zhongF
終	zhongFQ
緟	zhongFS
种	zhongH
種	zhongHQ
炂	zhongHS
煄	zhongHT
穜	zhongHU
柊	zhongIQ
钟	zhongJ
锺	zhongJP
鐘	zhongJQ
幒	zhongJS
鈡	zhongJT
銿	zhongJU
鍾	zhongJV
衷	zhongK
筗	zhongKQ
籦	zhongKS
衳	zhongKT
衶	zhongKU
中	zhongL
肿	zhongLP
腫	zhongLQ
盅	zhongM
冢	zhongMP
眾	zhongMQ
妐	zhongNQ
妕	zhongNS
媑	zhongNT
鴤	zhongNU
喠	zhongOQ
重	zhongP
狆	zhongQQ
祌	zhongSQ
鼨	zhongSS
堹	zhongTQ
塚	zhongTS
茽	zhongUQ
蔠	zhongUS
众	zhongV
仲	zhongVP
伀	zhongVQ
偅	zhongVS
斔	zhongWQ
忠	zhongX
忪	zhongXP
衆	zhongXQ
尰	zhongYQ
諥	zhongYS
踵	zhongZ
舯	zhongZP
歱	zhongZQ
蹱	zhongZS
掫	zhouAQ
宙	zhouB
疛	zhouBQ
賙	zhouBS
赒	zhouBT
州	zhouC
轴	zhouCP
軸	zhouCQ
徟	zhouCS
輈	zhouCT
輖	zhouCU
辀	zhouCV
洲	zhouE
淍	zhouEQ
绉	zhouF
繇	zhouFC
纣	zhouFP
紂	zhouFQ
縐	zhouFS
郮	zhouFT
炿	zhouHQ
烐	zhouHS
椆	zhouIQ
帚	zhouJ
銂	zhouJQ
籀	zhouK
箒	zhouKQ
籒	zhouKS
籕	zhouKT
肘	zhouL
胄	zhouLP
胕	zhouLQ
骤	zhouM
粥	zhouMP
驟	zhouMQ
盩	zhouMS
睭	zhouMT
粙	zhouMU
駎	zhouMV
駲	zhouMW
騆	zhouMX
妯	zhouN
婤	zhouNQ
鵃	zhouNS
鸼	zhouNT
周	zhouO
啁	zhouOC
咒	zhouOP
呪	zhouOQ
咮	zhouOS
喌	zhouOT
噣	zhouOU
嚋	zhouOV
皱	zhouP
碡	zhouPP
皺	zhouPQ
酎	zhouQ
昼	zhouR
晝	zhouRQ
晭	zhouRS
霌	zhouRT
矪	zhouSQ
冑	zhouTQ
荮	zhouU
菷	zhouUQ
葤	zhouUS
薵	zhouUT
伷	zhouVQ
侜	zhouVS
僽	zhouVT
珘	zhouWQ
甃	zhouWS
诌	zhouY
調	zhouYQ
翢	zhouYS
詋	zhouYT
謅	zhouYU
譸	zhouYV
诪	zhouYW
鯞	zhouYX
舟	zhouZ
週	zhouZQ
拄	zhuA
抓	zhuaA
挝	zhuaAP
撾	zhuaAQ
髽	zhuaBQ
蛀	zhuaC
拽	zhuaiA
轉	zhuaiCQ
睉	zhuaiMQ
檛	zhuaIQ
跩	zhuaiZQ
簻	zhuaKQ
膼	zhuaLQ
瞩	zhuaM
撰	zhuanA
赚	zhuanB
賺	zhuanBQ
转	zhuanC
專	zhuanCQ
専	zhuanCS
蟤	zhuanCT
転	zhuanCU
轉	zhuanCV
剸	zhuanDQ
漙	zhuanEQ
耑	zhuanES
縳	zhuanFQ
鄟	zhuanFS
撞	zhuangA
湷	zhuangEQ
漴	zhuangES
庄	zhuangG
庒	zhuangGQ
焋	zhuangHQ
桩	zhuangI
樁	zhuangIQ
梉	zhuangIS
幢	zhuangJ
装	zhuangK
裝	zhuangKQ
粧	zhuangMQ
糚	zhuangMS
妆	zhuangN
妝	zhuangNQ
娤	zhuangNS
壮	zhuangP
状	zhuangQ
狀	zhuangQQ
壯	zhuangSQ
壵	zhuangSS
莊	zhuangUQ
荘	zhuangUS
僮	zhuangV
戅	zhuangXQ
戇	zhuangXS
专	zhuanH
灷	zhuanHQ
篆	zhuanK
篹	zhuanKQ
篿	zhuanKS
簨	zhuanKT
籑	zhuanKU
襈	zhuanKV
竱	zhuanLQ
腞	zhuanLS
膞	zhuanLT
嫥	zhuanNQ
啭	zhuanO
囀	zhuanOQ
砖	zhuanP
磚	zhuanPQ
磗	zhuanPS
馔	zhuanS
叀	zhuanSQ
饌	zhuanSS
堟	zhuanTQ
塼	zhuanTS
蒃	zhuanUQ
传	zhuanV
傳	zhuanVQ
僎	zhuanVS
僝	zhuanVT
瑑	zhuanWQ
瑼	zhuanWS
甎	zhuanWT
恮	zhuanXQ
颛	zhuanY
諯	zhuanYQ
譔	zhuanYS
顓	zhuanYT
鱄	zhuanYU
孨	zhuanZQ
拀	zhuAQ
爪	zhuaZ
爫	zhuaZQ
贮	zhuB
疰	zhuBC
瘃	zhuBP
寧	zhuBQ
貯	zhuBS
宔	zhuBT
癷	zhuBU
蛛	zhuC
蛀	zhuCP
軴	zhuCQ
尌	zhuCS
徚	zhuCT
虲	zhuCU
蝊	zhuCV
蝫	zhuCW
蠋	zhuCX
蠩	zhuCY
蠾	zhuCZ
主	zhuD
劚	zhuDQ
注	zhuE
渚	zhuEC
洙	zhuED
潴	zhuEP
濐	zhuEQ
瀦	zhuES
灟	zhuET
邾	zhuF
紵	zhuFQ
紸	zhuFS
絑	zhuFT
纻	zhuFU
聁	zhuFV
陼	zhuFW
庻	zhuGQ
煮	zhuH
炷	zhuHC
爥	zhuHO
烛	zhuHP
燭	zhuHQ
稥	zhuHS
秼	zhuHT
炢	zhuHU
烪	zhuHV
焑	zhuHW
煑	zhuHX
燝	zhuHY
燞	zhuHZ
朱	zhuI
赘	zhuiB
贅	zhuiBQ
株	zhuIC
槠	zhuID
奞	zhuiDQ
橥	zhuIE
沝	zhuiEQ
缀	zhuiF
缒	zhuiFP
綴	zhuiFQ
杼	zhuIFR
隊	zhuiFS
縋	zhuiFT
椎	zhuiI
锥	zhuiJ
錐	zhuiJQ
錣	zhuiJS
鑆	zhuiJT
笍	zhuiKQ
腏	zhuiLQ
膇	zhuiLS
骓	zhuiM
騅	zhuiMQ
娷	zhuiNQ
鵻	zhuiNS
柱	zhuIP
硾	zhuiPQ
礈	zhuiPS
朮	zhuIQ
醊	zhuiQQ
柷	zhuIS
坠	zhuiT
墜	zhuiTQ
樦	zhuITR
畷	zhuiTS
櫡	zhuIU
萑	zhuiUR
櫧	zhuIV
櫫	zhuIW
甀	zhuiWQ
欘	zhuIX
惴	zhuiXR
諈	zhuiYQ
追	zhuiZ
隹	zhuiZP
铸	zhuJ
铢	zhuJP
鑄	zhuJQ
钃	zhuJS
帾	zhuJT
斸	zhuJU
鉒	zhuJV
銖	zhuJW
鋳	zhuJX
鍂	zhuJY
鐢	zhuJZ
筑	zhuK
竺	zhuKC
箸	zhuKD
竹	zhuKP
築	zhuKQ
袾	zhuKS
笁	zhuKT
笜	zhuKU
筯	zhuKV
篫	zhuKW
篴	zhuKX
簗	zhuKY
袰	zhuKZ
助	zhuL
麈	zhuLP
劯	zhuLQ
朑	zhuLS
竚	zhuLT
麆	zhuLU
驻	zhuM
馵	zhuMO
瞩	zhuMP
矚	zhuMQ
駐	zhuMS
鼄	zhuMT
駯	zhuMU
毜	zhuMV
毝	zhuMW
毮	zhuMX
眝	zhuMY
闧	zhuMZ
准	zhunB
凖	zhunBQ
宒	zhunBS
準	zhunEQ
綧	zhunFQ
屯	zhunH
稕	zhunHQ
肫	zhunL
啍	zhunOQ
孎	zhuNQ
旽	zhunRQ
鴸	zhuNS
鸀	zhuNT
圫	zhunTQ
埻	zhunTS
窀	zhunX
忳	zhunXQ
衠	zhunXS
谆	zhunY
諄	zhunYQ
訰	zhunYS
迍	zhunZQ
嘱	zhuO
捉	zhuoA
擢	zhuoAC
拙	zhuoAP
捔	zhuoAQ
撯	zhuoAS
擆	zhuoAT
彴	zhuoCQ
蠗	zhuoCS
蠿	zhuoCT
剢	zhuoDQ
劅	zhuoDS
浊	zhuoE
涿	zhuoEC
浞	zhuoED
濯	zhuoEP
濁	zhuoEQ
汋	zhuoES
灂	zhuoET
繳	zhuoFQ
聉	zhuoFS
灼	zhuoH
炪	zhuoHQ
烵	zhuoHS
燋	zhuoHT
穛	zhuoHU
穱	zhuoHV
桌	zhuoI
梲	zhuoIQ
棁	zhuoIS
棳	zhuoIT
椓	zhuoIU
槕	zhuoIV
櫡	zhuoIW
镯	zhuoJ
斮	zhuoJQ
斱	zhuoJS
斲	zhuoJT
斵	zhuoJU
鋜	zhuoJV
鐯	zhuoJW
鐲	zhuoJX
篧	zhuoKQ
籗	zhuoKS
籱	zhuoKT
着	zhuoM
妰	zhuoNQ
娺	zhuoNS
鵫	zhuoNT
鷟	zhuoNU
啄	zhuoO
啅	zhuoOQ
噣	zhuoOS
斫	zhuoP
硺	zhuoPQ
酌	zhuoQ
犳	zhuoQQ
囑	zhuOQR
晫	zhuoRQ
卓	zhuoS
禚	zhuoSP
罬	zhuoSQ
嗻	zhuOSR
圴	zhuoTQ
墌	zhuoTS
茁	zhuoU
蓔	zhuoUQ
藋	zhuoUS
倬	zhuoV
琢	zhuoW
斀	zhuoWQ
琸	zhuoWS
窡	zhuoXQ
窧	zhuoXS
诼	zhuoY
丵	zhuoYQ
叕	zhuoYS
諁	zhuoYT
諑	zhuoYU
謶	zhuoYV
属	zhuP
屬	zhuPQ
屗	zhuPS
殶	zhuPT
砫	zhuPU
硃	zhuPV
磩	zhuPW
猪	zhuQ
豬	zhuQQ
曢	zhuRQ
曯	zhuRS
霻	zhuRT
祝	zhuS
壴	zhuSQ
嵀	zhuSS
祩	zhuST
罜	zhuSU
飳	zhuSV
坾	zhuTQ
墸	zhuTS
著	zhuU
茱	zhuUC
苎	zhuUP
藸	zhuUQ
芧	zhuUS
苧	zhuUT
茿	zhuUU
莇	zhuUV
蒊	zhuUW
蓫	zhuUX
蕏	zhuUY
薴	zhuUZ
住	zhuV
侏	zhuVC
伫	zhuVP
佇	zhuVQ
珠	zhuW
敱	zhuWQ
敳	zhuWS
斀	zhuWT
術	zhuXQ
窋	zhuXS
诸	zhuY
翥	zhuYC
诛	zhuYP
註	zhuYQ
諸	zhuYS
羜	zhuYT
詝	zhuYU
誅	zhuYV
鮢	zhuYW
鯺	zhuYX
鱁	zhuYY
乼	zhuYZ
逐	zhuZ
舳	zhuZC
躅	zhuZP
艈	zhuZQ
跓	zhuZS
跦	zhuZT
迬	zhuZU
逫	zhuZV
资	ziB
髭	ziBC
赀	ziBD
兹	ziBP
茲	ziBQ
資	ziBS
貲	ziBT
龇	ziC
辎	ziCP
虸	ziCQ
輜	ziCS
輺	ziCT
齜	ziCU
剚	ziDQ
鼒	ziDS
滋	ziE
滓	ziEC
淄	ziED
渍	ziEP
沝	ziEQ
洓	ziES
湽	ziET
漬	ziEU
澬	ziEV
紫	ziF
缁	ziFP
紎	ziFQ
緇	ziFS
緕	ziFT
纃	ziFU
鄑	ziFV
秭	ziH
秄	ziHQ
秶	ziHS
稵	ziHT
梓	ziI
杍	ziIQ
栥	ziIS
椔	ziIT
榟	ziIU
锱	ziJ
觜	ziJP
釨	ziJQ
鈭	ziJS
錙	ziJT
鍿	ziJU
鎡	ziJV
镃	ziJW
笫	ziK
耔	ziL
胏	ziLQ
胔	ziLS
胾	ziLT
籽	ziM
粢	ziMC
眦	ziMP
眥	ziMQ
姿	ziN
姊	ziNP
姉	ziNQ
姕	ziNS
牸	ziNT
鶅	ziNU
咨	ziO
呲	ziOP
吇	ziOQ
呰	ziOS
啙	ziOT
嗞	ziOU
嗭	ziOV
矷	ziPQ
齍	ziQQ
嵫	ziS
崰	ziSQ
禌	ziSS
畠	ziTQ
茈	ziU
芓	ziUQ
茊	ziUS
茡	ziUT
荢	ziUU
菑	ziUV
葘	ziUW
蓻	ziUX
薋	ziUY
仔	ziV
倳	ziVQ
璾	ziWQ
恣	ziX
玆	ziXQ
谘	ziY
鲻	ziYC
訾	ziYD
孳	ziYP
訿	ziYQ
諮	ziYS
頾	ziYT
頿	ziYU
鯔	ziYV
鰦	ziYW
子	ziZ
字	ziZC
孜	ziZD
趑	ziZE
自	ziZP
孖	ziZQ
孶	ziZS
赼	ziZT
趦	ziZU
捴	zongAQ
揌	zongAS
揔	zongAT
搃	zongAU
摠	zongAV
宗	zongB
鬃	zongBP
疭	zongBQ
瘲	zongBS
鬉	zongBT
從	zongCQ
蝬	zongCS
潀	zongEQ
潈	zongES
潨	zongET
综	zongF
縦	zongFO
纵	zongFP
總	zongFQ
縱	zongFS
繌	zongFT
綜	zongFU
緃	zongFV
総	zongFW
緫	zongFX
緵	zongFY
縂	zongFZ
鬷	zongGQ
焧	zongHQ
熜	zongHS
熧	zongHT
燪	zongHU
稯	zongHV
棕	zongI
椶	zongIQ
樅	zongIS
鍐	zongJQ
鑁	zongJS
腙	zongL
朡	zongLQ
粽	zongM
糉	zongMQ
糭	zongMS
騌	zongMT
騣	zongMU
骔	zongMV
碂	zongPQ
磫	zongPS
猔	zongQQ
猣	zongQS
豵	zongQT
昮	zongRQ
嵏	zongSQ
嵕	zongSS
嵸	zongST
堫	zongTQ
葼	zongUQ
蓗	zongUS
偬	zongV
倊	zongVQ
倧	zongVS
傯	zongVT
总	zongX
惣	zongXQ
惾	zongXS
翪	zongYQ
鯮	zongYS
鯼	zongYT
踪	zongZ
蹤	zongZQ
踨	zongZS
揍	zouA
掫	zouAQ
搊	zouAS
齱	zouCQ
齺	zouCS
奏	zouD
邹	zouF
鄹	zouFC
陬	zouFP
緅	zouFQ
郰	zouFS
鄒	zouFT
棷	zouIQ
棸	zouIS
箃	zouKQ
黀	zouLQ
驺	zouM
騶	zouMQ
媰	zouNQ
菆	zouUQ
诹	zouY
鲰	zouYP
諏	zouYQ
鯫	zouYS
鯐	zouYT
走	zouZ
赱	zouZQ
攥	zuanA
揝	zuanAQ
賺	zuanBQ
劗	zuanDQ
缵	zuanF
繤	zuanFQ
纉	zuanFS
纘	zuanFT
钻	zuanJ
鑽	zuanJQ
鉆	zuanJS
鑚	zuanJT
纂	zuanK
篹	zuanKQ
籫	zuanKS
躜	zuanZ
躦	zuanZQ
组	zuF
阻	zuFC
族	zuFP
組	zuFQ
靻	zuGQ
租	zuH
稡	zuHQ
厜	zuiCQ
蟕	zuiCS
濢	zuiEQ
絊	zuiFQ
纗	zuiFS
稡	zuiHQ
栬	zuiIQ
槜	zuiIS
樶	zuiIT
檇	zuiIU
檌	zuiIV
欈	zuiIW
觜	zuiJ
鋷	zuiJQ
錊	zuiJS
朘	zuiLQ
脧	zuiLS
冣	zuiMQ
睟	zuiMS
嘴	zuiO
嗺	zuiOQ
噿	zuiOS
醉	zuiQ
酔	zuiQQ
酻	zuiQS
最	zuiR
晬	zuiRQ
罪	zuiS
嶊	zuiSQ
嶵	zuiSS
祽	zuiST
蕞	zuiU
璻	zuiWQ
辠	zuiXQ
柤	zuIY
椊	zuIZ
镞	zuJ
鎐	zuJQ
鏃	zuJS
鎺	zuJT
箤	zuKQ
撙	zunA
拵	zunAQ
捘	zunAS
尊	zunC
瀳	zunEQ
繜	zunFQ
罇	zunFS
樽	zunI
栫	zunIQ
銌	zunJQ
鐏	zunJS
袸	zunKQ
鷷	zunNQ
鶎	zunNS
噂	zunOQ
嶟	zunSQ
墫	zunTQ
僔	zunVQ
鳟	zunY
譐	zunYQ
鱒	zunYS
遵	zunZ
捽	zuoAQ
阼	zuoF
繓	zuoFQ
左	zuoG
座	zuoGP
秨	zuoHQ
稓	zuoHS
穝	zuoHT
柞	zuoI
柮	zuoIQ
鈼	zuoJQ
笮	zuoK
筰	zuoKQ
袏	zuoKS
胙	zuoL
糳	zuoMQ
唑	zuoO
嘬	zuoOP
咗	zuoOQ
唶	zuoOS
做	zuoP
酢	zuoQ
昨	zuoR
祚	zuoS
岝	zuoSQ
岞	zuoSS
飵	zuoST
坐	zuoT
唨	zuOU
苲	zuoUQ
莋	zuoUS
葃	zuoUT
葄	zuoUU
蓙	zuoUV
作	zuoV
佐	zuoVC
做	zuoVP
侳	zuoVQ
哫	zuOW
怍	zuoX
諎	zuoYQ
祖	zuS
卒	zuSP
卆	zuSQ
崒	zuSS
崪	zuST
菹	zuU
葅	zuUQ
蒩	zuUS
俎	zuV
倅	zuVQ
珇	zuWQ
怚	zuXQ
爼	zuXS
诅	zuY
詛	zuYQ
足	zuZ
踤	zuZQ
