阿	aaf
锕	aaj
錒	aajq
腌	aal
啊	aao
嗄	aaoc
吖	aaop
醃	aaqq
骯	aggq
枊	agiq
卬	agjq
肮	agl
盎	agm
醠	agqq
昂	agr
昻	agrq
岇	agsq
挨	aia
捱	aiap
癌	aib
皑	aibp
皚	aibq
凒	aibs
賹	aibt
皧	aibu
溾	aieq
溰	aies
濭	aiet
隘	aif
阨	aifq
隑	aifs
絠	aift
焥	aihq
锿	aij
鎄	aijq
鑀	aijs
哀	aik
毐	aimq
騃	aims
瞹	aimt
嫒	ain
嬡	ainq
娭	ains
娾	aint
鴱	ainu
唉	aio
嗳	aioc
嗌	aiod
哎	aiop
噯	aioq
啀	aios
嘊	aiot
碍	aip
砹	aipp
礙	aipq
硙	aips
硋	aipt
磑	aipu
欬	aiqq
欸	aiqs
暧	air
霭	airp
曖	airq
靄	airs
昹	airt
靉	airu
矮	ais
嵦	aisq
躷	aiss
餲	aist
埃	ait
堨	aitq
塧	aits
壒	aitt
艾	aiu
蔼	aiup
藹	aiuq
薆	aius
伌	aivq
佁	aivs
僾	aivt
瑷	aiw
璦	aiwq
敱	aiws
敳	aiwt
愛	aixq
懓	aixs
懝	aixt
馤	aixu
誒	aiyq
叆	aiys
諰	aiyt
譪	aiyu
譺	aiyv
鱫	aiyw
爱	aiz
按	ana
揞	anap
安	anb
痷	anbq
厈	ancq
洝	aneq
隌	anfq
鞍	ang
庵	angp
鞌	angq
黯	anh
案	ani
桉	anip
铵	anj
銨	anjq
錌	anjs
裺	ankq
胺	anl
腤	anlq
盦	anmq
闇	anms
盫	anmt
鹌	ann
鵪	annq
婩	anns
媕	annt
鶕	annu
咹	anoq
唵	anos
啽	anot
氨	anq
犴	anqp
暗	anr
晻	anrq
雸	anrs
岸	ans
屵	ansq
屽	anss
峖	anst
罯	ansu
埯	ant
垵	antq
堓	ants
荌	anuq
菴	anus
葊	anut
萻	anuu
蓭	anuv
俺	anv
侒	anvq
偣	anvs
儑	anvt
玵	anwq
馣	anxq
谙	any
諳	anyq
誝	anys
鮟	anyt
韽	anyu
豻	anzq
貋	anzs
拗	aoa
扷	aoaq
抝	aoas
摮	aoat
擙	aoau
镺	aobq
螯	aoc
軪	aocq
厫	aocs
奥	aod
奧	aodq
奡	aods
澳	aoe
泑	aoeq
滶	aoes
澚	aoet
聱	aof
郩	aofq
隞	aofs
隩	aoft
廒	aog
熬	aoh
熝	aohq
爊	aohs
柪	aoiq
梎	aois
鏊	aoj
凹	aok
袄	aokp
襖	aokq
鏖	aol
骜	aom
驁	aomq
眑	aoms
鼇	aomt
媪	aon
媼	aonq
嫯	aons
鷔	aont
嗷	aoo
囂	aooq
嗸	aoos
磝	aopq
獒	aoq
獓	aoqq
岙	aos
嶴	aosq
岰	aoss
嶅	aost
坳	aot
垇	aotq
墺	aots
芺	aouq
蔜	aous
傲	aov
敖	aow
璈	aowq
懊	aox
慠	aoxq
翱	aoy
鳌	aoyp
翺	aoyq
鰲	aoys
謷	aoyt
翶	aoyu
謸	aoyv
遨	aoz
把	baa
扒	baac
捌	baad
拔	baap
抜	baaq
扷	baas
八	bab
疤	babp
丷	babq
皅	babs
巼	babt
癹	babu
蚆	bacq
軷	bacs
夿	badq
灞	bae
爸	baf
颰	bafq
靶	bag
魃	bagp
弝	bagq
炦	bahq
朳	baiq
柭	bais
欛	bait
钯	baj
鈀	bajq
釟	bajs
笆	bak
耙	bal
胈	balq
粑	bam
妭	banq
吧	bao
叭	baop
哱	baoq
哵	baos
霸	bar
巴	bas
岜	basc
罢	basp
罷	basq
峇	bass
豝	bast
鼥	basu
矲	basv
坝	bat
壩	batq
垻	bats
芭	bau
菝	bauc
茇	baup
仈	bavq
玐	bawq
覇	baxq
鲅	bay
鮁	bayq
犮	bays
叐	bayt
羓	bayu
鲃	bayv
詙	bayw
鲌	bayx
魞	bayy
鮊	bayz
跋	baz
跁	bazq
报	bca
抱	bcap
包	bcb
勹	bcbc
宝	bcbp
寶	bcbq
勽	bcbs
宲	bcbt
寚	bcbu
髱	bcbv
賲	bcbw
寳	bcbx
龅	bcc
齙	bccq
蚫	bccs
忁	bcct
剥	bcd
剝	bcdq
瀑	bce
緥	bcfq
骲	bcgq
爆	bch
煲	bchc
炮	bchp
虣	bchq
枹	bciq
铇	bcjq
鉋	bcjs
鑤	bcjt
褒	bck
褓	bckp
笣	bckq
袌	bcks
裦	bckt
襃	bcku
胞	bcl
駂	bcmq
闁	bcms
鸨	bcn
鴇	bcnq
媬	bcns
鳵	bcnt
犦	bcnu
嚗	bcoq
犳	bcqq
暴	bcr
雹	bcrc
曝	bcrp
曓	bcrq
靌	bcrs
饱	bcs
飽	bcsq
飹	bcss
堡	bct
報	bctq
堢	bcts
薄	bcu
葆	bcuc
苞	bcup
菢	bcuq
蕔	bcus
藵	bcut
保	bcv
佨	bcvq
儤	bcvs
珤	bcwq
怉	bcxq
窇	bcxs
鲍	bcy
鮑	bcyq
豹	bcz
趵	bczc
孢	bczp
摆	bda
捭	bdac
掰	bdad
拜	bdap
擺	bdaq
拝	bdas
挀	bdat
白	bdb
败	bdbc
百	bdbp
贁	bdbq
絔	bdfq
庍	bdgq
稗	bdh
柏	bdi
栢	bdiq
兡	bdkq
襬	bdks
竡	bdlq
粨	bdmq
粺	bdms
犤	bdnq
唄	bdoq
猈	bdqq
薭	bduq
佰	bdv
敗	bdwq
瓸	bdws
韛	bdwt
捹	bgaq
撪	bgas
賁	bgbq
蟦	bgcq
奔	bgd
夯	bgdp
夲	bgdq
奙	bgds
泍	bgeq
渀	bges
漰	bget
體	bggq
炃	bghq
本	bgi
栟	bgiq
桳	bgis
楍	bgit
锛	bgj
錛	bgjq
笨	bgk
犇	bgnq
喯	bgoq
坌	bgt
畚	bgtp
坋	bgtq
苯	bgu
倴	bgvq
翉	bgyq
逩	bgzq
挷	bhaq
捠	bhas
搒	bhat
蚌	bhc
蚄	bhcq
蛖	bhcs
蜯	bhct
浜	bhe
邦	bhf
绑	bhfp
綁	bhfq
邫	bhfs
縍	bhft
鞤	bhgq
髈	bhgs
稖	bhhq
棒	bhi
梆	bhic
榜	bhip
棓	bhiq
帮	bhj
镑	bhjp
幫	bhjq
鎊	bhjs
幇	bhjt
幚	bhju
膀	bhl
磅	bhp
硥	bhpq
牓	bhps
垹	bhtq
塝	bhts
蒡	bhu
傍	bhv
玤	bhwq
谤	bhy
謗	bhyq
艕	bhzq
比	bib
鼻	bibc
毙	bibd
痹	bibe
毖	bibf
匕	bibg
贲	bibh
贔	bibo
毕	bibp
賁	bibq
皀	bibs
疕	bibt
疪	bibu
皕	bibv
貱	bibw
赑	bibx
痺	biby
髲	bibz
彼	bic
蜌	bicq
螕	bics
夶	bidq
豍	bids
奰	bidt
滗	bie
濞	biep
潷	bieq
沘	bies
湢	biet
滭	bieu
鄙	bif
繴	bifo
陛	bifp
紕	bifq
邲	bifs
旇	bift
紴	bifu
聛	bifv
鄪	bifw
綼	bifx
縪	bify
鄨	bifz
弊	big
庳	bigc
弼	bigd
髀	bige
庇	bigp
弻	bigq
彃	bigs
廦	bigt
鞞	bigu
鞸	bigv
魓	bigw
秕	bih
煏	bihq
稫	bihs
熚	biht
朼	biiq
柲	biis
柀	biit
梐	biiu
楅	biiv
榌	biiw
币	bij
铋	bijp
幣	bijq
鉍	bijs
幤	bijt
觱	biju
鏎	bijv
鎞	bijw
鐴	bijx
笔	bik
裨	bikc
箅	bikd
篦	bike
襞	bikf
筚	bikp
筆	bikq
篳	biks
笓	bikt
袐	biku
箆	bikv
箄	bikw
襅	bikx
襣	biky
臂	bil
肶	bilq
胇	bils
腷	bilt
闭	bim
鼊	biml
驆	bimm
駜	bimn
閟	bimo
睥	bimp
閉	bimq
闬	bims
毞	bimt
粊	bimu
粃	bimv
閈	bimw
閇	bimx
毴	bimy
睤	bimz
妣	bin
嬖	binc
婢	binp
妼	binq
娝	bins
嬶	bint
鵖	binu
鶝	binv
鷝	binw
鷩	binx
吡	bio
哔	biop
嗶	bioq
咇	bios
啚	biot
碧	bip
屄	bipq
狴	biq
獙	biqq
獘	biqs
朇	birq
祕	bisq
崥	biss
禆	bist
飶	bisu
罼	bisv
饆	bisw
壁	bit
畀	bitp
畢	bitq
坒	bits
畁	bitt
畐	bitu
堛	bitv
蔽	biu
芘	biuc
荜	biud
荸	biue
萆	biuf
薜	biug
蓖	biup
蓽	biuq
苾	bius
萞	biut
俾	biv
佖	bivq
佊	bivs
偪	bivt
敝	biw
璧	biwp
斃	biwq
珌	biws
韠	biwt
必	bix
愎	bixc
辟	bixp
怭	bixq
怶	bixs
愊	bixt
馝	bixu
诐	biyq
翍	biys
詖	biyt
鮅	biyu
鲾	biyv
鰏	biyw
避	biz
舭	bizc
跸	bizd
逼	bizp
蹕	bizq
迊	bizs
貏	bizt
躃	bizu
躄	bizv
抃	bjaq
揙	bjas
贬	bjb
貶	bjbq
疺	bjbs
蝙	bjc
釆	bjcq
徧	bjcs
卞	bjd
汴	bje
汳	bjeq
编	bjf
缏	bjfc
匾	bjfp
編	bjfq
緶	bjfs
鞭	bjg
弁	bjgp
鞕	bjgq
扁	bjh
煸	bjhp
炞	bjhq
稨	bjhs
覍	bjjq
鍽	bjjs
覵	bjjt
笾	bjk
褊	bjkp
籩	bjkq
箯	bjks
籓	bjkt
閞	bjmq
糄	bjms
鴘	bjnq
鶣	bjns
砭	bjp
碥	bjpp
牑	bjpq
猵	bjqq
獱	bjqs
昪	bjrq
峅	bjsq
苄	bju
萹	bjuq
藊	bjus
便	bjv
玣	bjwq
甂	bjws
辩	bjx
辫	bjxc
忭	bjxd
窆	bjxe
辨	bjxp
辮	bjxq
辯	bjxs
惼	bjxt
辡	bjxu
辧	bjxv
变	bjy
鳊	bjyp
變	bjyq
鯿	bjys
諚	bjyt
鯾	bjyu
边	bjz
遍	bjzp
邊	bjzq
辺	bjzs
変	bjzt
臱	bjzu
艑	bjzv
邉	bjzw
兺	bkbq
搬	bla
扳	blac
拌	blad
扮	blap
搫	blaq
半	blb
癍	blbc
瘢	blbp
蝂	blcq
螁	blcs
螌	blct
湴	bleq
绊	blf
阪	blfp
絆	blfq
靽	blgq
秚	blhq
板	bli
柈	bliq
钣	blj
鈑	bljq
鉡	bljs
褩	blkq
办	bll
朌	bllq
肦	blls
粄	blmq
闆	blms
姅	blnq
鳻	blns
版	blp
昄	blrq
岅	blsq
坂	blt
坢	bltq
伴	blv
班	blw
斑	blwp
瓪	blwq
攽	blws
斒	blwt
瓣	blx
辦	blxq
怑	blxs
辬	blxt
颁	bly
頒	blyq
魬	blys
般	blz
舨	blzp
跘	blzq
摽	bmaq
髟	bmb
瘭	bmbp
贆	bmbq
淲	bmeq
滮	bmes
瀌	bmet
飑	bmf
飚	bmfc
飙	bmfp
颮	bmfq
飆	bmfs
飈	bmft
颩	bmfu
颷	bmfv
飇	bmfw
飊	bmfx
灬	bmh
熛	bmhq
爂	bmhs
穮	bmht
标	bmi
標	bmiq
檦	bmis
镖	bmj
镳	bmjp
鏢	bmjq
鑣	bmjs
幖	bmjt
鋲	bmju
錶	bmjv
表	bmk
裱	bmkp
褾	bmkq
篻	bmks
膘	bml
脿	bmlq
膔	bmls
麃	bmlt
臕	bmlu
骠	bmm
驃	bmmq
骉	bmms
驫	bmmt
婊	bmn
嫑	bmnq
磦	bmpq
猋	bmqq
彪	bms
墂	bmtq
蔈	bmuq
藨	bmus
俵	bmvq
僄	bmvs
儦	bmvt
鳔	bmy
鰾	bmyq
諘	bmys
謤	bmyt
播	boa
拨	boac
擘	boad
搏	boap
撥	boaq
挬	boas
卜	bob
癶	bobq
皪	bobs
彴	bocq
蚾	bocs
剥	bod
剝	bodq
殕	bods
波	boe
渤	boec
泊	boep
浡	boeq
淿	boes
溊	boet
缽	bofq
郣	bofs
紴	boft
瓝	bogq
瓟	bogs
髆	bogt
髉	bogu
秡	bohq
煿	bohs
穛	boht
柏	boi
檗	boip
柭	boiq
栢	bois
桲	boit
榑	boiu
檘	boiv
欂	boiw
钵	boj
铂	bojc
钹	bojd
帛	bojp
鉑	bojq
鈸	bojs
鉢	bojt
镈	boju
鋍	bojv
鎛	bojw
鑮	bojx
箔	bok
簸	bokp
袯	bokq
袹	boks
襏	bokt
簙	boku
襮	bokv
脖	bol
膊	bolc
勃	bolp
肑	bolq
胉	bols
驳	bom
駁	bomq
盋	boms
駮	bomt
糪	bomu
驋	bomv
鹁	bon
鵓	bonq
啵	boo
哱	booq
噃	boos
嚗	boot
礴	bop
砵	bopq
碆	bops
牔	bopt
磻	bopu
礡	bopv
狛	boqq
猼	boqs
博	bos
饽	bosp
餑	bosq
馎	boss
嶓	bost
餺	bosu
亳	bot
壆	botq
薄	bou
菠	boup
蔔	bouq
蘗	bous
苩	bout
萡	bouu
葧	bouv
伯	bov
仢	bovq
侼	bovs
僰	bovt
僠	bovu
玻	bow
愽	boxq
馛	boxs
馞	boxt
懪	boxu
鲌	boyq
誖	boys
鮊	boyt
謈	boyu
譒	boyv
鱍	boyw
舶	boz
踣	bozc
跛	bozp
艊	bozq
孹	bozs
蹳	bozt
揹	bpaq
北	bpb
贝	bpbp
貝	bpbq
辈	bpc
輩	bpcq
軰	bpcs
蛽	bpct
邶	bpf
陂	bpfp
郥	bpfq
鄁	bpfs
鞴	bpg
鞁	bpgq
骳	bpgs
鞞	bpgt
焙	bph
杯	bpi
杮	bpiq
柸	bpis
桮	bpit
梖	bpiu
棑	bpiv
椑	bpiw
棓	bpix
钡	bpj
鐾	bpjp
鋇	bpjq
鉳	bpjs
被	bpk
褙	bpkp
箄	bpkq
背	bpl
盃	bpmq
糒	bpms
鹎	bpn
鵯	bpnq
牬	bpns
犕	bpnt
呗	bpo
唄	bpoq
碑	bpp
碚	bppp
狈	bpq
狽	bpqq
昁	bprq
卑	bps
禙	bpsq
蓓	bpu
苝	bpuq
藣	bpus
倍	bpv
備	bpvq
俻	bpvs
偝	bpvt
偹	bpvu
僃	bpvv
珼	bpwq
琲	bpws
悲	bpx
悖	bpxc
惫	bpxp
憊	bpxq
愂	bpxs
誖	bpyq
諀	bpys
备	bpz
孛	bpzp
瘪	btb
癟	btbq
蛂	btcq
徶	btcs
蟞	btct
别	btd
別	btdq
彆	btgq
龞	btgs
柭	btiq
柲	btis
襒	btkq
鼈	btmq
莂	btuq
虌	btus
憋	btx
鳖	bty
鱉	btyq
蹩	btz
捕	bua
抪	buaq
捗	buas
捬	buat
卜	bub
轐	bucq
部	buf
郶	bufq
巭	bugq
庯	bugs
廍	bugt
不	buh
柨	buiq
布	buj
钸	bujc
钚	bujp
鈈	bujq
鈽	bujs
錻	bujt
补	buk
簿	bukp
補	bukq
箁	buks
篰	bukt
勏	bulq
婄	bunq
鳪	buns
鵏	bunt
鸔	bunu
哺	buo
卟	buop
吥	buoq
咘	buos
醭	buq
晡	bur
峬	busq
餔	buss
餢	bust
埔	but
埠	butp
埗	butq
蔔	buuq
荹	buus
蔀	buut
佈	buvq
瓿	buw
怖	bux
悑	buxq
誧	buyq
鯆	buys
步	buz
逋	buzp
歨	buzq
歩	buzs
踄	buzt
摈	bxa
擯	bxaq
宾	bxb
鬓	bxbp
賓	bxbq
鬢	bxbs
髩	bxbt
賔	bxbu
鬂	bxbv
蠙	bxcq
殡	bxd
殯	bxdq
滨	bxe
濒	bxep
濱	bxeq
瀕	bxes
汃	bxet
濵	bxeu
缤	bxf
繽	bxfq
邠	bxfs
髌	bxg
髕	bxgq
虨	bxhq
槟	bxi
檳	bxiq
梹	bxis
椕	bxit
镔	bxj
鑌	bxjq
膑	bxl
臏	bxlq
砏	bxpq
霦	bxrq
彬	bxs
豳	bxsp
豩	bxsq
傧	bxv
儐	bxvq
斌	bxw
玢	bxwp
瑸	bxwq
璸	bxws
頻	bxyq
顮	bxys
摒	bya
抦	byaq
掤	byas
兵	byb
冰	bybc
病	bybd
冫	bybe
并	bybp
並	bybq
寎	bybs
蛃	bycq
氷	byeq
邴	byf
綆	byfq
陃	byfs
絣	byft
幷	bygq
庰	bygs
鞆	bygt
鞞	bygu
鞸	bygv
秉	byh
丙	byhc
炳	byhp
稟	byhq
柄	byi
槟	byip
檳	byiq
栤	byis
栟	byit
梹	byiu
棅	byiv
鈵	byjq
鉼	byjs
竝	bylq
眪	bymq
屏	byp
屛	bypq
昞	byrq
昺	byrs
靐	byrt
饼	bys
禀	bysp
餅	bysq
餠	byss
垪	bytq
苪	byuq
仌	byvq
仒	byvs
併	byvt
倂	byvu
偋	byvv
傡	byvw
琕	bywq
怲	byxq
窉	byxs
誁	byyq
鮩	byys
揼	bzaq
痭	bzbq
蚌	bzc
蜯	bzcq
奟	bzdq
泵	bze
绷	bzf
繃	bzfq
絣	bzfs
綳	bzft
鞛	bzgq
镚	bzjq
鏰	bzjs
閍	bzmq
嘣	bzo
嗙	bzoq
崩	bzs
祊	bzsq
嵭	bzss
埄	bztq
埲	bzts
塴	bztt
菶	bzuq
伻	bzvq
甏	bzw
琫	bzwq
琣	bzws
甭	bzy
甮	bzyq
蹦	bzz
迸	bzzp
逬	bzzq
跰	bzzs
擦	caa
攃	caaq
嚓	cao
囃	caoq
礤	cap
礸	capq
遪	cazq
操	cca
撡	ccaq
螬	ccc
漕	cce
鄵	ccfq
鼜	ccgq
槽	cci
鏪	ccjq
鏕	ccjs
褿	cckq
襙	ccks
屮	ccl
肏	cclq
糙	ccm
騲	ccmq
嘈	cco
曹	ccr
曺	ccrq
嶆	ccsq
墽	cctq
草	ccu
艹	ccup
艸	ccuq
蓸	ccus
傮	ccvq
愺	ccxq
慅	ccxs
慒	ccxt
懆	ccxu
艚	ccz
才	cda
扐	cdaq
採	cdas
揌	cdat
财	cdb
財	cdbq
宷	cdbs
寀	cdbt
采	cdc
綵	cdfq
縩	cdfs
纔	cdft
材	cdi
棌	cdiq
裁	cdk
睬	cdm
婇	cdnq
啋	cdoq
猜	cdq
彩	cds
埰	cdtq
菜	cdu
蔡	cdup
倸	cdvq
偲	cdvs
踩	cdz
跴	cdzq
拺	ceaq
厕	cec
厠	cecq
夨	cedq
测	cee
測	ceeq
廁	cegq
策	cek
笧	cekq
筴	ceks
筞	cekt
箣	ceku
簎	cekv
粣	cemq
册	cep
冊	cetq
畟	cets
荝	ceuq
萗	ceus
萴	ceut
蓛	ceuu
侧	cev
側	cevq
敇	cewq
恻	cex
惻	cexq
憡	cexs
凑	cfb
辏	cfc
輳	cfcq
湊	cfeq
楱	cfi
腠	cfl
傶	cfvq
涔	cge
汵	cgeq
穇	cghq
梣	cgiq
笒	cgkq
篸	cgks
参	cgs
岑	cgsp
參	cgsq
叄	cgss
叅	cgst
嵾	cgsu
埁	cgtq
凔	chbq
賶	chbs
螥	chcq
沧	che
滄	cheq
濸	ches
匨	chfq
鑶	chjq
篬	chkq
鸧	chnq
鶬	chns
獊	chqq
嵢	chsq
藏	chu
苍	chup
蒼	chuq
仓	chv
伧	chvp
倉	chvq
傖	chvs
仺	chvt
玱	chwq
瑲	chws
舱	chz
艙	chzq
赐	cib
疵	cibp
賜	cibq
皉	cibs
蛓	cicq
螆	cics
蠀	cict
齹	cicu
刺	cid
刾	cidq
泚	cieq
濨	cies
絘	cifq
縒	cifs
差	cig
庛	cigq
骴	cigs
髊	cigt
朿	ciiq
柌	ciis
栨	ciit
糍	cim
鹚	cin
鶿	cinq
嬨	cins
鴜	cint
鷀	cinu
呰	cioq
啙	cios
磁	cip
礠	cipq
次	ciq
祠	cis
飺	cisq
餈	ciss
垐	citq
茨	ciu
茈	ciup
茦	ciuq
莿	cius
薋	ciut
乲	civq
佌	civs
佽	civt
偨	civu
瓷	ciw
珁	ciwq
玼	ciws
甆	ciwt
辞	cix
慈	cixp
辭	cixq
辝	cixs
辤	cixt
词	ciy
詞	ciyq
鮆	ciys
此	ciz
雌	cizp
趀	cizq
跐	cizs
拵	ckaq
寸	ckc
刌	ckdq
澊	ckeq
邨	ckfq
村	cki
膥	cklq
竴	ckls
籿	ckmq
吋	ckoq
皴	ckp
墫	cktq
侟	ckvq
忖	ckx
存	ckz
踆	ckzq
摻	claq
摲	clas
蚕	clc
蠶	clcq
蝅	clcs
蠺	clct
残	cld
殘	cldq
湌	cleq
澯	cles
灿	clh
黪	clhp
燦	clhq
黲	clhs
穇	clht
爘	clhu
鏒	cljq
篸	clkq
骖	clm
粲	clmp
驂	clmq
嬠	clnq
喰	cloq
嘇	clos
囋	clot
孱	clp
朁	clrq
参	cls
餐	clsp
參	clsq
飡	clss
叄	clst
叅	clsu
飱	clsv
薒	cluq
傪	clvq
儏	clvs
璨	clw
惨	clx
惭	clxp
慚	clxq
慘	clxs
慙	clxt
憯	clxu
謲	clyq
措	coa
挫	coac
撮	coad
搓	coap
痤	cob
瘥	cobp
厝	coc
齹	cocq
剉	codq
剒	cods
縒	cofq
酂	cofs
酇	coft
庴	cogq
虘	cohq
错	coj
锉	cojp
錯	cojq
銼	cojs
鎈	cojt
脞	col
鹾	colp
鹺	colq
睉	comq
磋	cop
醝	coqq
嵯	cos
矬	cosp
嵳	cosq
莡	couq
莝	cous
蒫	cout
蓌	couu
蔖	couv
瑳	cowq
諎	coyq
蹉	coz
夎	cozq
逪	cozs
遳	cozt
攒	cra
撺	crap
攢	craq
攛	cras
攅	crat
殩	crdq
汆	cre
濽	creq
灒	cres
爨	crh
熶	crhq
穳	crhs
櫕	criq
欑	cris
镩	crj
鑹	crjq
鋑	crjs
篡	crk
簒	crkq
巑	crsq
菆	cruq
窜	crx
竄	crxq
窽	crxs
窾	crxt
蹿	crz
躥	crzq
匆	csb
賩	csbq
賨	csbs
從	cscq
徔	cscs
従	csct
徖	cscu
蟌	cscv
淙	cse
潀	cseq
潈	cses
漗	cset
漎	cseu
潨	csev
灇	csew
聪	csf
聰	csfq
聡	csfs
聦	csft
繱	csfu
丛	csh
焧	cshq
熜	cshs
爜	csht
枞	csi
樅	csiq
棇	csis
楤	csit
樬	csiu
樷	csiv
欉	csiw
錝	csjq
鍯	csjs
鏓	csjt
鏦	csju
篵	cskq
骢	csm
驄	csmq
瞛	csms
騘	csmt
婃	csnq
囱	csp
碂	cspq
暰	csrq
葱	csu
苁	csup
蔥	csuq
蓯	csus
茐	csut
藂	csuu
从	csv
琮	csw
璁	cswp
囪	cswq
瑽	csws
忩	csxq
怱	csxs
悤	csxt
悰	csxu
愡	csxv
慒	csxw
憁	csxx
叢	csyq
誴	csys
謥	csyt
孮	cszq
瘄	cubq
瘯	cubs
徂	cuc
殂	cud
縬	cufq
橻	cuiq
觕	cujq
簇	cuk
脨	culq
麁	culs
麄	cult
麆	culu
麤	culv
粗	cum
鼀	cumq
媨	cunq
噈	cuoq
皻	cupq
醋	cuq
酢	cuqc
猝	cuqp
卒	cus
蔟	cuu
促	cuv
怚	cuxq
憱	cuxs
誎	cuyq
顣	cuys
蹙	cuz
蹴	cuzp
趨	cuzq
趗	cuzs
踧	cuzt
踿	cuzu
蹵	cuzv
摧	cva
瘁	cvb
疩	cvbq
凗	cvbs
皠	cvbt
淬	cve
漼	cveq
濢	cves
紣	cvfq
缞	cvfs
綷	cvft
縗	cvfu
焠	cvhq
熣	cvhs
榱	cvi
椊	cviq
槯	cvis
鏙	cvjq
衰	cvk
襊	cvkq
脆	cvl
脃	cvlq
脺	cvls
膵	cvlt
膬	cvlu
臎	cvlv
粹	cvm
毳	cvmp
粋	cvmq
啐	cvo
啛	cvoq
磪	cvpq
獕	cvqq
崔	cvs
崒	cvsq
嵟	cvss
墔	cvtq
萃	cvu
催	cvv
伜	cvvq
倅	cvvs
璀	cvw
琗	cvwq
悴	cvx
忰	cvxq
慛	cvxs
竁	cvxt
翠	cvy
翆	cvyq
顇	cvys
趡	cvzq
橧	cziq
竲	czlq
驓	czmq
噌	czo
层	czp
層	czpq
曾	czr
曽	czrq
嶒	czsq
蹭	czz
打	daa
搭	daap
撘	daaq
瘩	dab
匒	dabq
蟽	dacq
大	dad
耷	dadp
剳	dadq
沓	dae
汏	daeq
溚	daes
繨	dafq
靼	dag
鞑	dagp
韃	dagq
炟	dahq
燵	dahs
鎝	dajq
鎉	dajs
鐽	dajt
答	dak
褡	dakc
笪	dakp
笚	dakq
龖	dalq
龘	dals
眔	damq
妲	dan
哒	dao
嗒	daop
噠	daoq
咑	daos
呾	daot
亣	datq
垯	dats
畗	datt
畣	datu
墶	datv
荙	dauq
荅	daus
薘	daut
囗	daw
怛	dax
憚	daxq
羍	dayq
詚	days
达	daz
達	dazq
迏	dazs
迖	dazt
迚	dazu
逹	dazv
跶	dazw
躂	dazx
捣	dca
搗	dcaq
捯	dcas
擣	dcat
导	dcc
導	dccq
衜	dccs
螩	dcct
衟	dccu
到	dcd
刂	dcdc
刀	dcdp
纛	dcf
陦	dcfq
絩	dcfs
隝	dcft
隯	dcfu
稻	dch
焘	dchp
燾	dchq
稲	dchs
朷	dciq
梼	dcis
椡	dcit
槝	dciu
檤	dciv
檮	dciw
幬	dcjq
釖	dcjs
裯	dckq
箌	dcks
盗	dcm
盜	dcmq
叨	dco
嘄	dcoq
噵	dcos
氘	dcq
岛	dcs
祷	dcsp
島	dcsq
禱	dcss
禂	dcst
嶋	dcsu
嶌	dcsv
嶹	dcsw
軇	dcsx
壔	dctq
菿	dcuq
倒	dcv
瓙	dcwq
悼	dcx
鱽	dcyq
魛	dcys
翢	dcyt
翿	dcyu
道	dcz
蹈	dczp
辺	dczq
舠	dczs
艔	dczt
贷	ddb
貸	ddbq
貣	ddbs
待	ddc
轪	ddcq
軑	ddcs
軚	ddct
蚮	ddcu
軩	ddcv
蝳	ddcw
歹	ddd
殆	dddp
歺	dddq
瀻	ddeq
绐	ddf
紿	ddfq
緿	ddfs
戴	ddg
甙	ddgp
廗	ddgq
黛	ddh
黱	ddhq
柋	ddiq
带	ddj
帶	ddjq
帒	ddjs
帯	ddjt
釱	ddju
袋	ddk
箉	ddkq
簤	ddks
襶	ddkt
隸	ddlq
隷	ddls
駘	ddmq
鴏	ddnq
呆	ddo
呔	ddop
獃	ddqq
曃	ddrq
霴	ddrs
靆	ddrt
岱	dds
埭	ddt
垈	ddtq
代	ddv
傣	ddvp
侢	ddvq
玳	ddw
瑇	ddwq
怠	ddx
懛	ddxq
詒	ddyq
叇	ddys
逮	ddz
迨	ddzp
跢	ddzq
艜	ddzs
蹛	ddzt
的	deb
得	dec
德	decp
蚮	decq
徳	decs
淂	deeq
棏	deiq
锝	dej
鍀	dejq
脦	delq
嘚	deoq
旳	derq
地	det
恴	dexq
惪	dexs
悳	dext
抖	dfa
痘	dfb
蚪	dfc
斗	dfd
豆	dfdp
鬥	dfdq
剅	dfds
鬦	dfdt
斣	dfdu
鬪	dfdv
鬭	dfdw
鬬	dfdx
兜	dfe
瀆	dfeq
浢	dfes
兠	dfet
都	dff
陡	dffp
阧	dffq
郖	dffs
枓	dfiq
梪	dfis
橷	dfit
钭	dfj
鈄	dfjq
鋀	dfjs
篼	dfk
脰	dflq
毭	dfmq
閗	dfms
瞗	dfmt
闘	dfmu
吋	dfoq
吺	dfos
唗	dfot
唞	dfou
狵	dfqq
酘	dfqs
饾	dfsq
餖	dfss
畓	dftq
蔸	dfu
荳	dfuq
乧	dfvq
侸	dfvs
窦	dfx
竇	dfxq
讀	dfyq
逗	dfz
扥	dgaq
扽	dgas
挡	dha
擋	dhaq
攩	dhas
宕	dhb
蟷	dhcq
党	dhe
氹	dheq
潒	dhes
澢	dhet
灙	dheu
黨	dhhq
档	dhi
檔	dhiq
欓	dhis
铛	dhj
鐺	dhjq
裆	dhk
襠	dhkq
筜	dhks
簜	dhkt
簹	dhku
瞊	dhmq
盪	dhms
闣	dhmt
婸	dhnq
噹	dhoq
砀	dhp
碭	dhpq
礑	dhps
雼	dhrq
崵	dhsq
嵣	dhss
場	dhtq
當	dhts
圵	dhtt
垱	dhtu
壋	dhtv
荡	dhu
蕩	dhuq
蘯	dhus
偒	dhvq
儅	dhvs
珰	dhwq
瓽	dhws
璫	dhwt
璗	dhwu
当	dhx
愓	dhxq
谠	dhy
讜	dhyq
譡	dhys
逿	dhzq
趤	dhzs
艡	dhzt
抵	dia
扚	diaq
拞	dias
掋	diat
揥	diau
摕	diav
的	dib
弟	dibp
髢	dibq
厎	dicq
彽	dics
蚳	dict
軧	dicu
蝃	dicv
蝭	dicw
螮	dicx
奃	didq
滴	die
涤	diep
滌	dieq
浟	dies
渧	diet
缔	dif
邸	difp
締	difq
阺	difs
隄	dift
聜	difu
底	dig
骶	digp
弤	digq
靮	digs
鞮	digt
秪	dihq
焍	dihs
柢	dii
棣	diip
杕	diiq
枤	diis
枑	diit
梊	diiu
梑	diiv
楴	diiw
樀	diix
帝	dij
镝	dijc
觌	dijp
鏑	dijq
覿	dijs
釱	dijt
觝	diju
鉪	dijv
第	dik
笛	dikp
袛	dikq
篴	diks
肑	dilq
腣	dils
籴	dim
睇	dimp
糴	dimq
眱	dims
馰	dimt
嫡	din
娣	dinp
牴	dinq
媂	dins
鸐	dint
嘀	dio
呧	dioq
哋	dios
唙	diot
啲	diou
啇	diov
嚁	diow
砥	dip
碲	dipp
碮	dipq
磾	dips
狄	diq
旳	dirq
氐	dis
祗	disp
岻	disq
祶	diss
禘	dist
嵽	disu
嶳	disv
豴	disw
地	dit
坻	ditc
堤	ditp
墑	ditq
坘	dits
坔	ditt
埅	ditu
埊	ditv
埞	ditw
墆	ditx
墬	dity
蒂	diu
荻	diup
蓧	diuq
苖	dius
苐	diut
菂	diuu
菧	diuv
蔕	diuw
蔐	diux
蔋	diuy
藡	diuz
低	div
仾	divq
俤	divs
偙	divt
僀	divu
敌	diw
敵	diwq
玓	diws
珶	diwt
甋	diwu
怟	dixq
慸	dixs
翟	diy
羝	diyc
谛	diyd
诋	diyp
詆	diyq
諦	diys
廸	diyt
頔	diyu
諟	diyv
鯳	diyw
迪	diz
递	dizp
遞	dizq
逓	dizs
趆	dizt
遆	dizu
疐	dizv
遰	dizw
踶	dizx
蹢	dizy
掂	dja
攧	djaq
典	djb
癫	djbc
癜	djbp
癲	djbq
痁	djbs
痶	djbt
瘨	djbu
厧	djcq
蜔	djcs
齻	djct
奠	djd
丶	djdp
奌	djdq
淀	dje
滇	djep
澱	djeq
阽	djf
店	djg
点	djh
點	djhq
扂	djhs
椣	djiq
槙	djis
槇	djit
橝	djiu
橂	djiv
钿	djj
鈿	djjq
簟	djk
驔	djmq
婰	djnq
婝	djns
嚸	djoq
殿	djp
碘	djpp
磹	djpq
靛	djq
猠	djqq
電	djrq
巅	djs
巔	djsq
嵮	djss
巓	djst
电	djt
甸	djtc
坫	djtd
垫	djtp
墊	djtq
壂	djts
蒧	djuq
蕇	djus
佃	djv
佔	djvq
傎	djvs
玷	djw
敁	djwq
琔	djws
敟	djwt
惦	djx
窴	djxq
颠	djy
顛	djyq
顚	djys
踮	djz
跕	djzq
蹎	djzs
撴	dkaq
撉	dkas
蜳	dkcq
沌	dke
潡	dkeq
庉	dkgq
炖	dkh
燉	dkhq
楯	dkiq
橔	dkis
钝	dkj
鈍	dkjq
鐓	dkjs
盾	dkm
盹	dkmp
驐	dkmq
犜	dknq
吨	dko
噸	dkoq
砘	dkp
礅	dkpp
碷	dkpq
獤	dkqq
壿	dksq
墩	dkt
坉	dktq
墫	dkts
墪	dktt
伅	dkvq
敦	dkw
囤	dkwp
忳	dkxq
惇	dkxs
憞	dkxt
顿	dky
頓	dkyq
蹲	dkz
趸	dkzc
遁	dkzp
躉	dkzq
逇	dkzs
遯	dkzt
踲	dkzu
蹾	dkzv
担	dla
掸	dlap
撣	dlaq
擔	dlas
抌	dlat
撢	dlau
单	dlb
赕	dlbc
瘅	dlbd
疸	dlbp
賧	dlbq
癉	dlbs
髧	dlbt
癚	dlbu
贉	dlbv
蛋	dlc
蜑	dlcq
殚	dld
殫	dldq
刐	dlds
淡	dle
澹	dlep
泹	dleq
沊	dles
耽	dlf
聃	dlfc
郸	dlfp
鄲	dlfq
耼	dlfs
紞	dlft
匰	dlfu
聸	dlfv
繵	dlfw
弹	dlg
彈	dlgq
弾	dlgs
黕	dlhq
燀	dlhs
黮	dlht
黵	dlhu
柦	dliq
帎	dljq
觛	dljs
凼	dlk
箪	dlkp
簞	dlkq
衴	dlks
褝	dlkt
襌	dlku
胆	dll
膽	dllq
腅	dlls
勯	dllt
眈	dlm
馾	dlmq
駳	dlms
妉	dlnq
媅	dlns
鴠	dlnt
啖	dlo
單	dloq
呾	dlos
唌	dlot
啗	dlou
啿	dlov
噉	dlow
嘾	dlox
嚪	dloy
石	dlp
丹	dlpp
砃	dlpq
皽	dlps
氮	dlq
狚	dlqq
酖	dlqs
醈	dlqt
旦	dlr
霮	dlrq
単	dlsq
躭	dlss
餤	dlst
禫	dlsu
饏	dlsv
亶	dltq
萏	dlu
菪	dlup
蓞	dluq
但	dlv
儋	dlvp
伔	dlvq
僤	dlvs
玬	dlwq
瓭	dlws
甔	dlwt
惮	dlx
憚	dlxq
惔	dlxs
愖	dlxt
窞	dlxu
憺	dlxv
诞	dly
誕	dlyq
訑	dlys
頕	dlyt
疍	dlzq
掉	dma
扚	dmaq
凋	dmb
瘹	dmbq
虭	dmcq
蛁	dmcs
刁	dmd
刟	dmdq
奝	dmds
汈	dmeq
絩	dmfq
弔	dmgq
弴	dmgs
椆	dmiq
钓	dmj
铞	dmjp
釣	dmjq
銱	dmjs
銚	dmjt
鈟	dmju
鋽	dmjv
錭	dmjw
鑃	dmjx
簓	dmkq
竨	dmlq
盄	dmmq
瞗	dmms
鳥	dmnq
鳭	dmns
鵰	dmnt
吊	dmo
叼	dmop
碉	dmp
屌	dmpq
雿	dmrq
彫	dmsq
鼦	dmss
蓧	dmuq
藋	dmus
伄	dmvq
琱	dmwq
窎	dmxq
窵	dmxs
调	dmy
鲷	dmyp
調	dmyq
鯛	dmys
訋	dmyt
誂	dmyu
魡	dmyv
鮉	dmyw
雕	dmz
貂	dmzp
颩	dnfq
丟	dnhq
铥	dnj
銩	dnjq
丢	dnp
掇	doa
挆	doaq
挅	doas
痥	dobq
凙	dobs
鬌	dobt
夺	dod
剁	dodp
奪	dodq
刴	dods
剟	dodt
剫	dodu
奲	dodv
沲	doe
澤	doeq
沰	does
缍	dof
綞	dofq
陏	dofs
陊	doft
隓	dofu
度	dog
朵	doi
朶	doiq
杕	dois
杝	doit
枤	doiu
柂	doiv
柮	doiw
桗	doix
椯	doiy
铎	doj
鐸	dojq
鈬	dojs
裰	dok
袳	dokq
馱	domq
毲	doms
駄	domt
媠	donq
鵽	dons
哆	doo
哚	dooc
咄	doop
喥	dooq
嚉	doos
嚲	doot
硾	dopq
躲	dos
饳	dosq
崜	doss
躱	dost
飿	dosu
軃	dosv
堕	dot
垛	dotp
墮	dotq
垜	dots
埵	dott
墯	dotu
亸	dotv
仛	dovq
敓	dowq
敚	dows
敠	dowt
敪	dowu
多	dox
惰	doxp
夛	doxq
憜	doxs
尮	doyq
跺	doz
踱	dozc
舵	dozp
趓	dozq
跢	dozs
跥	dozt
嘚	dpoq
剬	drdq
耑	dreq
缎	drf
緞	drfq
煅	drh
椴	dri
断	drj
锻	drjp
鍛	drjq
斷	drjs
鍴	drjt
簖	drk
籪	drkq
褍	drks
端	drl
腶	drlq
媏	drnq
段	drp
碫	drpq
毈	drps
短	drs
塅	drtq
葮	druq
偳	drvq
瑖	drwq
躖	drzq
挏	dsaq
揰	dsas
冻	dsb
凍	dsbq
蝀	dscq
洞	dse
涷	dseq
湩	dses
絧	dsfq
戙	dsgq
鼕	dsgs
东	dsh
烔	dshq
燑	dshs
栋	dsi
東	dsiq
棟	dsis
笗	dskq
箽	dsks
动	dsl
胴	dslc
胨	dslp
動	dslq
腖	dsls
勭	dslt
駧	dsmq
鸫	dsn
鶇	dsnq
姛	dsns
娻	dsnt
嬞	dsnu
鶫	dsnv
咚	dso
硐	dsp
氡	dsq
狪	dsqq
氭	dsqs
昸	dsrq
霘	dsrs
岽	dss
峒	dssp
崠	dssq
崬	dsss
垌	dst
埬	dstq
墥	dsts
董	dsu
苳	dsuq
菄	dsus
蕫	dsut
侗	dsv
倲	dsvq
働	dsvs
懂	dsx
恫	dsxp
諌	dsyq
鮗	dsys
鯟	dsyt
冬	dsz
迵	dszq
揲	dta
挕	dtaq
镻	dtbq
蝶	dtc
軼	dtcq
蜨	dtcs
螲	dtct
殜	dtdq
泆	dteq
爹	dtf
绖	dtfq
絰	dtfs
瓞	dtg
戜	dtgq
鞢	dtgs
柣	dtiq
楪	dtis
槢	dtit
幉	dtjq
褋	dtkq
褺	dtks
耋	dtl
胅	dtlq
耊	dtls
眣	dtmq
眰	dtms
氎	dtmt
鴩	dtnq
喋	dto
哋	dtoq
咥	dtos
啑	dtot
碟	dtp
牒	dtpp
牃	dtpq
昳	dtrq
曡	dtrs
峌	dtsq
崼	dtss
嵽	dtst
垤	dtt
堞	dttp
疊	dttq
畳	dtts
疂	dttt
疉	dttu
苵	dtuq
怢	dtxq
恎	dtxs
惵	dtxt
叠	dty
鲽	dtyc
谍	dtyp
諜	dtyq
鰈	dtys
詄	dtyt
跌	dtz
迭	dtzp
臷	dtzq
趃	dtzs
跕	dtzt
跮	dtzu
艓	dtzv
蹛	dtzw
赌	dub
賭	dubq
凟	dubs
贕	dubt
蠹	duc
螙	ducq
蠧	ducs
剢	dudq
殬	duds
殰	dudt
渡	due
渎	duep
瀆	dueq
涜	dues
都	duf
匵	dufq
度	dug
髑	dugp
靯	dugq
豄	dugs
韇	dugt
黩	duh
黷	duhq
秺	duhs
杜	dui
椟	duip
櫝	duiq
镀	duj
鍍	dujq
覩	dujs
錖	dujt
鑟	duju
笃	duk
篤	dukq
裻	duks
肚	dul
毒	dum
睹	dumc
督	dump
阇	dumq
闍	dums
騳	dumt
妒	dun
犊	dunp
犢	dunq
妬	duns
姤	dunt
嬻	dunu
嘟	duo
叾	duoq
牍	dup
牘	dupq
皾	dups
独	duq
獨	duqq
醏	duqs
暏	durq
晵	durs
厾	dusq
堵	dut
芏	duu
荰	duuq
琽	duwq
斁	duws
瓄	duwt
韣	duwu
韥	duwv
读	duy
頓	duyq
讀	duys
読	duyt
讟	duyu
兑	dvb
痽	dvbq
对	dvc
對	dvcq
対	dvcs
轛	dvct
兌	dveq
兊	dves
濧	dvet
濻	dveu
瀢	dvev
瀩	dvew
队	dvf
隊	dvfq
陮	dvfs
綐	dvft
杸	dviq
镦	dvj
鐓	dvjq
錞	dvjs
鐜	dvjt
鴭	dvnq
啍	dvoq
碓	dvp
磓	dvpq
祋	dvsq
堆	dvt
垖	dvtq
塠	dvts
薱	dvuq
敦	dvw
敓	dvwq
敚	dvws
怼	dvx
憝	dvxp
懟	dvxq
憞	dvxs
頧	dvyq
譈	dvys
譵	dvyt
嗲	dwo
掟	dyaq
定	dyb
疔	dybp
虰	dycq
鼎	dyd
鼑	dydq
濎	dyeq
耵	dyf
聢	dyfq
靪	dygq
丁	dyh
椗	dyiq
钉	dyj
锭	dyjp
釘	dyjq
錠	dyjs
鋌	dyjt
帄	dyju
鐤	dyjv
腚	dyl
盯	dym
奵	dynq
叮	dyo
啶	dyop
碇	dyp
矴	dypq
碠	dyps
磸	dypt
酊	dyq
饤	dysq
飣	dyss
嵿	dyst
町	dyt
甼	dytq
艼	dyuq
萣	dyus
薡	dyut
仃	dyv
玎	dyw
忊	dyxq
顶	dyy
订	dyyp
訂	dyyq
頂	dyys
顁	dyyt
登	dzb
豋	dzdq
澂	dzeq
瀓	dzes
邓	dzf
鄧	dzfq
隥	dzfs
戥	dzg
灯	dzh
燈	dzhq
櫈	dziq
凳	dzj
镫	dzjp
鐙	dzjq
覴	dzjs
等	dzk
簦	dzkp
竳	dzlq
瞪	dzm
嬁	dznq
噔	dzo
磴	dzp
嶝	dzs
墱	dztq
僜	dzvq
璒	dzwq
憕	dzxq
蹬	dzz
艠	dzzq
扼	eea
搕	eeaq
搹	eeas
搤	eeat
擜	eeau
匎	eebq
皒	eebs
痾	eebt
痷	eebu
齃	eebv
蛾	eec
轭	eecc
厄	eecp
軛	eecq
蚅	eecs
軶	eect
蝁	eecu
齶	eecv
洝	eeeq
涐	eees
湂	eeet
阿	eef
鄂	eefp
阨	eefq
阸	eefs
廅	eegq
戹	eehq
枙	eeiq
櫮	eeis
锇	eej
锷	eejp
鋨	eejq
鍔	eejs
卾	eejt
鈪	eeju
鈋	eejv
覨	eejw
鑩	eejx
腭	eel
閼	eemq
睋	eems
騀	eemt
鹅	een
婀	eenc
鹗	eend
娥	eenp
鵝	eenq
鶚	eens
妸	eent
妿	eenu
姶	eenv
娿	eenw
娾	eenx
鵈	eeny
鵞	eenz
哦	eeo
噩	eeoc
呃	eeop
吪	eeoq
呝	eeos
咢	eeot
咹	eeou
噁	eeov
屙	eep
砐	eepq
砈	eeps
砨	eept
硆	eepu
磀	eepv
礘	eepw
歞	eeqq
饿	ees
峨	eesp
餓	eesq
岋	eess
峉	eest
峩	eesu
豟	eesv
崿	eesw
餩	eesx
垩	eet
堊	eetq
堨	eets
堮	eett
苊	eeu
萼	eeuc
莪	eeup
蕚	eeuq
俄	eev
偔	eevq
僫	eevs
囮	eewq
敋	eews
珴	eewt
琧	eewu
恶	eex
愕	eexp
惡	eexq
悪	eexs
额	eey
谔	eeyc
颚	eeyd
鳄	eeye
讍	eeyk
鰪	eeyl
鰐	eeym
譌	eeyn
頞	eeyo
讹	eeyp
訛	eeyq
額	eeys
諤	eeyt
顎	eeyu
鱷	eeyv
頋	eeyw
誐	eeyx
魤	eeyy
頟	eeyz
遏	eez
迗	eezq
遌	eezs
遻	eezt
鞥	eggq
欸	eiqq
诶	eiy
誒	eiyq
摁	ena
奀	endq
煾	enhq
嗯	eno
峎	ensq
蒽	enu
恩	enx
贰	erb
貳	erbq
貮	erbs
髶	erbt
髵	erbu
輀	ercq
轜	ercs
刵	erdq
而	ere
二	erec
洱	ered
儿	erep
兒	ereq
児	eres
耏	eret
洏	ereu
耳	erf
陑	erfq
聏	erfs
隭	erft
杒	eriq
栮	eris
栭	erit
梕	eriu
樲	eriv
铒	erj
鉺	erjq
袻	erkq
胹	erlq
臑	erls
毦	ermq
粫	erms
駬	ermt
鸸	ern
鴯	ernq
咡	eroq
唲	eros
饵	ers
餌	ersq
峏	erss
荋	eruq
薾	erus
侕	ervq
乻	ervs
珥	erw
尔	erx
爾	erxq
尓	erxs
尒	erxt
衈	erxu
鲕	ery
鮞	eryq
弍	erys
弐	eryt
誀	eryu
迩	erz
邇	erzq
趰	erzs
發	fabq
冹	fabs
疺	fabt
発	fabu
髪	fabv
髮	fabw
法	fae
沷	faeq
浌	faes
灋	faet
彂	fagq
栰	faiq
橃	fais
鍅	fajq
筏	fak
笩	fakq
阀	fam
閥	famq
瞂	fams
姂	fanq
乏	fap
砝	fapp
酦	faqq
醗	faqs
醱	faqt
罚	fas
罰	fasq
峜	fass
罸	fast
垡	fat
坺	fatq
墢	fats
茷	fauq
蕟	faus
藅	faut
伐	fav
佱	favq
傠	favs
珐	faw
琺	fawq
发	fay
殕	ffdq
缶	fff
缻	fffq
缹	fffs
紑	ffft
炰	ffhq
妚	ffnq
鴀	ffns
否	ffo
雬	ffrq
蚡	fgcq
蚠	fgcs
轒	fgct
分	fgd
奋	fgdp
奮	fgdq
汾	fge
瀵	fgep
濆	fgeq
纷	fgf
紛	fgfq
隫	fgfs
弅	fggq
鼖	fggs
焚	fgh
炃	fghq
秎	fghs
燓	fght
燌	fghu
棼	fgi
枌	fgiq
棻	fgis
梤	fgit
橨	fgiu
帉	fgjq
鈖	fgjs
幩	fgjt
鐼	fgju
衯	fgkq
朌	fglq
竕	fgls
膹	fglt
粉	fgm
粪	fgmp
糞	fgmq
瞓	fgms
黂	fgmt
妢	fgnq
鳻	fgns
吩	fgo
哛	fgoq
砏	fgpq
氛	fgq
酚	fgqp
獖	fgqq
昐	fgrq
雰	fgrs
朆	fgrt
鼢	fgs
岎	fgsq
躮	fgss
豮	fgst
餴	fgsu
豶	fgsv
饙	fgsw
坟	fgt
墳	fgtq
坆	fgts
坋	fgtt
芬	fgu
蒶	fguq
蕡	fgus
份	fgv
偾	fgvp
僨	fgvq
瓰	fgwq
愤	fgx
忿	fgxp
憤	fgxq
馚	fgxs
馩	fgxt
鲼	fgy
鱝	fgyq
羒	fgys
翂	fgyt
訜	fgyu
魵	fgyv
黺	fgyw
羵	fgyx
髣	fhbq
蚄	fhcq
汸	fheq
淓	fhes
方	fhf
纺	fhfc
匚	fhfd
邡	fhfe
防	fhfp
紡	fhfq
旊	fhfs
房	fhh
枋	fhi
钫	fhj
鈁	fhjq
錺	fhjs
肪	fhl
眆	fhmq
眪	fhms
妨	fhn
牥	fhnq
鴋	fhns
鶭	fhnt
昉	fhrq
昘	fhrs
祊	fhsq
坊	fht
埅	fhtq
堏	fhts
芳	fhu
仿	fhv
倣	fhvq
放	fhw
瓬	fhwq
访	fhy
鲂	fhyp
訪	fhyq
魴	fhys
舫	fhz
趽	fhzq
払	flaq
贩	flb
販	flbq
軓	flcq
軬	flcs
輽	flct
轓	flcu
蠜	flcv
樊	fld
泛	fle
氾	fleq
汎	fles
滼	flet
瀪	fleu
瀿	flev
繁	flf
匥	flfq
緐	flfs
旙	flft
旛	flfu
繙	flfv
颿	flfw
飜	flfx
烦	flh
燔	flhp
煩	flhq
梵	fli
杋	fliq
柉	flis
桳	flit
棥	fliu
橎	fliv
凡	flj
钒	fljc
幡	fljd
帆	fljp
釩	fljq
凣	fljs
凢	fljt
鐇	flju
範	flkq
笵	flks
笲	flkt
襎	flku
籓	flkv
勫	fllq
膰	flls
籵	flmq
盕	flms
奿	flnq
婏	flns
嬏	flnt
嬎	flnu
鷭	flnv
噃	floq
矾	flp
礬	flpq
犯	flq
犿	flqq
饭	fls
飯	flsq
飰	flss
番	flt
畈	fltp
畨	fltq
墦	flts
范	flu
蕃	fluc
蘩	flud
藩	flup
薠	fluq
仮	flvq
攵	flw
璠	flwq
忛	flxq
憣	flxs
反	fly
翻	flyp
訉	flyq
羳	flys
鱕	flyt
返	flz
蹯	flzc
夂	flzp
舤	flzq
舧	flzs
覅	fmxq
梻	foiq
坲	fotq
佛	fov
仏	fovq
仸	fovs
费	fpb
痱	fpbp
費	fpbq
發	fpbs
疿	fpbt
癈	fpbu
蜚	fpc
厞	fpcq
蜰	fpcs
蟦	fpct
剕	fpdq
奜	fpds
沸	fpe
淝	fpep
渄	fpeq
濷	fpes
非	fpf
匪	fpfc
绯	fpfd
飞	fpfp
飛	fpfq
緋	fpfs
陫	fpft
靟	fpfu
飝	fpfv
废	fpg
廢	fpgq
廃	fpgs
扉	fph
榧	fpi
杮	fpiq
柹	fpis
棐	fpit
橨	fpiu
橃	fpiv
櫠	fpiw
镄	fpj
鐨	fpjq
篚	fpk
笰	fpkq
裶	fpks
肥	fpl
腓	fplc
肺	fplp
胏	fplq
胇	fpls
朏	fplt
胐	fplu
騑	fpmq
騛	fpms
妃	fpn
婓	fpnq
婔	fpns
啡	fpo
吠	fpop
砩	fpp
屝	fppq
狒	fpq
犻	fpqq
猆	fpqs
霏	fpr
昲	fprq
暃	fprs
曊	fprt
靅	fpru
餥	fpsq
鼣	fpss
菲	fpu
芾	fpup
萉	fpuq
蕜	fpus
俷	fpvq
斐	fpw
悱	fpx
馡	fpxq
诽	fpy
鲱	fpyc
翡	fpyp
誹	fpyq
鯡	fpys
扶	fua
拂	fuac
拊	fuad
抚	fuap
撫	fuaq
払	fuas
抙	fuat
捊	fuau
捬	fuav
负	fub
赋	fubc
匐	fubd
赙	fube
富	fubp
負	fubq
賦	fubs
賻	fubt
髴	fubu
癁	fubv
辅	fuc
蚨	fucc
蜉	fucd
蝠	fuce
蝮	fucf
輹	fucn
蝜	fuco
辐	fucp
復	fucq
輔	fucs
輻	fuct
彿	fucu
尃	fucv
蚥	fucw
蚹	fucx
蛗	fucy
蜅	fucz
夫	fud
副	fudp
刜	fudq
浮	fue
滏	fuec
涪	fuep
泭	fueq
洑	fues
澓	fuet
父	fuf
纀	fufb
缚	fufc
釜	fufd
阜	fufe
阝	fuff
绂	fufg
绋	fufh
郛	fufi
緮	fufj
颰	fufk
綒	fufl
綍	fufm
鄜	fufn
颫	fufo
附	fufp
縛	fufq
紱	fufs
紼	fuft
邞	fufu
郙	fufv
釡	fufw
旉	fufx
紨	fufy
絥	fufz
府	fug
弗	fugp
弣	fugq
鬴	fugs
稃	fuh
炥	fuhq
虙	fuhs
烰	fuht
秿	fuhu
焤	fuhv
稪	fuhw
桴	fui
榑	fuio
枎	fuiq
柭	fuis
柎	fuit
枹	fuiu
柫	fuiv
栿	fuiw
棴	fuix
椨	fuiy
椱	fuiz
幅	fuj
凫	fujc
幞	fujd
斧	fujp
巿	fujq
帗	fujs
鈇	fujt
鉜	fuju
鉘	fujv
鍢	fujw
鍑	fujx
符	fuk
襥	fukm
簠	fukn
複	fuko
袱	fukp
襆	fukq
衭	fuks
袚	fukt
袝	fuku
笰	fukv
筟	fukw
箙	fukx
箁	fuky
褔	fukz
服	ful
肤	fulc
脯	fuld
腑	fule
腹	fulp
膚	fulq
竎	fuls
胕	fult
驸	fum
麸	fump
駙	fumq
麩	fums
冨	fumt
盙	fumu
粰	fumv
麬	fumw
糐	fumx
麱	fumy
妇	fun
鶝	funk
鵩	funl
嬔	funm
鴔	funn
鳺	funo
婦	funq
鳧	funs
乀	funt
妋	funu
姇	funv
鳬	funw
娐	funx
婏	funy
媍	funz
咐	fuo
呒	fuoc
呋	fuop
嘸	fuoq
咈	fuos
哹	fuot
喸	fuou
砆	fupq
氟	fuq
酜	fuqq
腐	fur
福	fus
祓	fusc
艴	fusd
罘	fusp
岪	fusq
峊	fuss
祔	fust
罦	fusu
豧	fusv
禣	fusw
甶	futq
坿	futs
垘	futt
畐	futu
畉	futv
垺	futw
畗	futx
莆	fuu
芾	fuuc
苻	fuud
茯	fuue
莩	fuuf
菔	fuug
芙	fuup
芣	fuuq
茀	fuus
荂	fuut
荴	fuuu
葍	fuuv
萯	fuuw
蓲	fuux
蕧	fuuy
付	fuv
傅	fuvc
俘	fuvd
俯	fuve
伏	fuvp
乥	fuvq
伕	fuvs
乶	fuvt
俌	fuvu
俛	fuvv
偩	fuvw
敷	fuw
玞	fuwq
玸	fuws
韨	fuwt
琈	fuwu
韍	fuwv
璷	fuww
覆	fux
馥	fuxc
怫	fuxp
怤	fuxq
覄	fuxs
懯	fuxt
甫	fuy
鲋	fuyc
黻	fuyd
鳆	fuye
黼	fuyf
讣	fuyp
訃	fuyq
鮒	fuys
鰒	fuyt
翇	fuyu
詂	fuyv
頫	fuyw
鮄	fuyx
諨	fuyy
鮲	fuyz
复	fuz
孵	fuzc
孚	fuzd
趺	fuze
跗	fuzf
赴	fuzp
艀	fuzq
踾	fuzs
摓	fzaq
疯	fzb
冯	fzbp
瘋	fzbq
赗	fzbs
賵	fzbt
寷	fzbu
封	fzc
蜂	fzcp
蠭	fzcq
奉	fzd
豐	fzdq
沣	fze
灃	fzeq
沨	fzes
浲	fzet
湗	fzeu
溄	fzev
渢	fzew
漨	fzex
风	fzf
酆	fzfc
缝	fzfp
風	fzfq
縫	fzfs
綘	fzft
鄷	fzfu
飌	fzfv
烽	fzh
炐	fzhq
焨	fzhs
煈	fzht
熢	fzhu
枫	fzi
楓	fziq
桻	fzis
檒	fzit
锋	fzj
凤	fzjp
鋒	fzjq
凨	fzjs
凬	fzjt
凮	fzju
鎽	fzjv
鏠	fzjw
篈	fzkq
丰	fzl
馮	fzmq
盽	fzms
麷	fzmt
鳳	fznq
妦	fzns
犎	fznt
鳯	fznu
鴌	fznv
唪	fzo
砜	fzp
碸	fzpq
猦	fzqq
靊	fzrq
峰	fzs
峯	fzsq
崶	fzss
埄	fztq
堼	fzts
堸	fztt
葑	fzu
莑	fzuq
蘴	fzus
俸	fzv
仹	fzvq
偑	fzvs
僼	fzvt
琒	fzwq
覂	fzxq
讽	fzy
諷	fzyq
逢	fzz
夆	fzzq
艂	fzzs
轧	gac
軋	gacq
夹	gad
夾	gadq
魀	gagq
钆	gaj
釓	gajq
錷	gajs
朒	galq
嘎	gao
噶	gaop
嘠	gaoq
旮	gar
垓	gat
玍	gawq
尕	gax
尜	gaxp
尬	gay
搞	gca
皋	gcb
皐	gcbq
夰	gcdq
郜	gcf
缟	gcfp
縞	gcfq
高	gcg
髙	gcgq
鼛	gcgs
稿	gch
稁	gchq
稾	gchs
杲	gci
槁	gcic
槔	gcip
橰	gciq
槀	gcis
槹	gcit
檺	gciu
櫜	gciv
镐	gcj
锆	gcjp
鎬	gcjq
鋯	gcjs
篙	gck
筶	gckq
膏	gcl
勂	gclq
糕	gcm
睪	gcmq
鷎	gcnq
鷱	gcns
告	gco
吿	gcoq
睾	gcp
獋	gcqq
暠	gcrq
峼	gcsq
祮	gcss
祰	gcst
禞	gcsu
餻	gcsv
藁	gcu
菒	gcuq
藳	gcus
韟	gcwq
羔	gcy
诰	gcyp
誥	gcyq
羙	gcys
臯	gczq
摡	gdaq
赅	gdb
賅	gdbq
匃	gdbs
匄	gdbt
賌	gdbu
溉	gde
漑	gdeq
陔	gdf
郂	gdfq
隑	gdfs
絠	gdft
絯	gdfu
戤	gdg
丐	gdh
概	gdi
杚	gdiq
槩	gdis
槪	gdit
钙	gdj
鈣	gdjq
盖	gdm
姟	gdnq
硙	gdpq
磑	gdps
晐	gdrq
峐	gdsq
祴	gdss
豥	gdst
畡	gdtq
芥	gdu
蓋	gduq
荄	gdus
葢	gdut
乢	gdvq
侅	gdvs
改	gdw
瓂	gdwq
忋	gdxq
该	gdy
該	gdyq
搁	gea
搿	geap
擱	geaq
扢	geas
挌	geat
疙	geb
匌	gebq
蛤	gec
虼	gecp
蛒	gecq
輵	gecs
轕	gect
割	ged
滒	geeq
滆	gees
隔	gef
纥	gefp
紇	gefq
革	geg
鬲	gegc
骼	gegd
戈	gegp
戓	gegq
彁	gegs
戨	gegt
鞈	gegu
鞷	gegv
格	gei
槅	geiq
櫊	geis
铬	gej
镉	gejp
鉻	gejq
鎘	gejs
觡	gejt
鎑	geju
鎶	gejv
袼	gek
笴	gekq
裓	geks
箇	gekt
胳	gel
膈	gelp
肐	gelq
臈	gels
阁	gem
閣	gemq
閤	gems
騔	gemt
鸽	gen
鴿	genq
牫	gens
鴚	gent
哥	geo
合	geoc
咯	geod
哿	geoe
嗝	geof
各	geop
吤	geoq
呄	geos
嘅	geot
嗰	geou
硌	gep
歌	geq
犵	geqq
猲	geqs
獦	geqt
饹	gesq
餎	gess
圪	get
塥	getp
葛	geu
蓋	geuq
茖	geus
虄	geut
个	gev
仡	gevp
個	gevq
佮	gevs
佫	gevt
敋	gewq
韐	gews
韚	gewt
愅	gexq
颌	gey
頜	geyq
鲄	geys
魺	geyt
諽	geyu
鮯	geyv
鮥	geyw
謌	geyx
舸	gez
臵	gezq
搆	gfaq
撀	gfas
购	gfb
勾	gfbp
購	gfbq
痀	gfbs
蚼	gfcq
沟	gfe
溝	gfeq
缑	gff
緱	gffq
鞲	gfg
煹	gfhq
构	gfi
枸	gfip
構	gfiq
钩	gfj
觏	gfjp
鉤	gfjq
覯	gfjs
鈎	gfjt
笱	gfk
篝	gfkp
袧	gfkq
褠	gfks
簼	gfkt
耇	gflq
耉	gfls
耈	gflt
糓	gfmq
媾	gfn
姤	gfnq
呴	gfoq
啂	gfos
彀	gfp
狗	gfq
岣	gfs
垢	gft
坸	gftq
冓	gfts
苟	gfu
芶	gfuq
佝	gfv
傋	gfvq
韝	gfwq
玽	gfws
够	gfx
夠	gfxq
诟	gfy
詬	gfyq
訽	gfys
遘	gfz
豿	gfzq
雊	gfzs
搄	ggaq
揯	ggas
亙	ggeq
艮	ggg
亘	ggh
根	ggi
哏	ggo
茛	ggu
跟	ggz
掆	ghaq
摃	ghas
冮	ghbq
疘	ghbs
刚	ghd
剛	ghdq
港	ghe
纲	ghf
缸	ghfp
綱	ghfq
罁	ghfs
焵	ghhq
焹	ghhs
杠	ghi
棡	ghiq
槓	ghis
钢	ghj
鋼	ghjq
釭	ghjs
鎠	ghjt
筻	ghk
肛	ghl
牨	ghnq
犅	ghns
矼	ghpq
碙	ghps
犺	ghqq
岗	ghs
罡	ghsp
岡	ghsq
崗	ghss
冈	ght
堈	ghtq
堽	ghts
戆	ghx
戇	ghxq
戅	ghxs
怾	gixq
辊	gkc
輥	gkcq
滚	gke
滾	gkeq
绲	gkf
緄	gkfq
緷	gkfs
棍	gki
袞	gkkq
裷	gkks
丨	gkl
睔	gkmq
磙	gkp
硍	gkpq
衮	gkt
蓘	gkuq
蔉	gkus
惃	gkxq
鲧	gky
鯀	gkyq
鮌	gkys
謴	gkyt
擀	gla
赣	glb
疳	glbp
贛	glbq
凎	glbs
贑	glbt
泔	gle
澉	glec
淦	glep
汵	gleq
漧	gles
澸	glet
灨	gleu
绀	glf
紺	glfq
干	glg
甘	glgp
幹	glgq
骭	glgs
魐	glgt
秆	glh
稈	glhq
杆	gli
橄	glic
柑	glip
桿	gliq
榦	glis
檊	glit
凲	gljq
竿	glk
衦	glkq
笴	glks
筸	glkt
篢	glku
簳	glkv
肝	gll
盰	glmq
粓	glms
姏	glnq
鳱	glns
咁	gloq
矸	glp
皯	glpq
酐	glq
旰	glr
坩	glt
苷	glu
芉	gluq
仠	glvq
佄	glvs
乹	glvt
倝	glvu
亁	glvv
敢	glw
玕	glwq
攼	glws
玵	glwt
感	glx
忓	glxq
尴	gly
尷	glyq
詌	glys
尲	glyt
尶	glyu
鳡	glyv
鱤	glyw
赶	glz
趕	glzq
迀	glzs
掴	goa
摑	goaq
瘑	gobq
蜾	goc
蝈	gocp
蟈	gocq
輠	gocs
渦	goeq
淉	goes
漍	goet
濄	goeu
郭	gof
聒	gofp
聝	gofq
綶	gofs
彉	gogq
彍	gogs
虢	goh
果	goi
椁	goip
槨	goiq
楇	gois
櫎	goit
锅	goj
帼	gojp
鍋	gojq
幗	gojs
鈛	gojt
鐹	goju
裹	gok
褁	gokq
簂	goks
腂	golq
腘	gols
膕	golt
粿	gomq
矌	goms
呙	goo
咼	gooq
咶	goos
喐	goot
啯	goou
嘓	goov
猓	goq
崞	gos
馘	gosp
馃	gosq
餜	goss
埚	got
堝	gotq
墎	gots
菓	gouq
蔮	gous
国	gow
國	gowq
囯	gows
囶	gowt
囻	gowu
圀	gowv
敋	goww
惈	goxq
慖	goxs
懖	goxt
过	goz
過	gozq
给	gpf
給	gpfq
挄	gqaq
撗	gqas
臦	gqcq
輄	gqcs
臩	gqct
洸	gqeq
广	gqg
廣	gqgq
広	gqgs
灮	gqhq
炗	gqhs
炚	gqht
炛	gqhu
烡	gqhv
黆	gqhw
桄	gqi
銧	gqjq
胱	gql
姯	gqnq
咣	gqo
硄	gqpq
犷	gqq
獷	gqqq
垙	gqtq
茪	gquq
俇	gqvq
僙	gqvs
珖	gqwq
光	gqx
逛	gqz
掼	gra
摜	graq
关	grb
贯	grbc
官	grbp
貫	grbq
卝	grbs
痯	grbt
瘝	grbu
癏	grbv
輨	grcq
灌	gre
涫	grep
泴	greq
淉	gres
潅	gret
罐	grf
纶	grfp
綸	grfq
罆	grfs
爟	grhq
棺	gri
樌	griq
欟	gris
观	grj
觀	grjq
覌	grjs
錧	grjt
観	grju
鏆	grjv
鑵	grjw
管	grk
筦	grkq
丱	grlq
冠	grm
盥	grmc
矜	grmp
關	grmq
毌	grms
矝	grmt
閞	grmu
関	grmv
闗	grmw
矔	grmx
鹳	grn
鸛	grnq
礶	grpq
馆	grs
館	grsq
豘	grss
祼	grst
莞	gru
蒄	gruq
倌	grv
舘	grvq
琯	grwq
璭	grws
瓘	grwt
惯	grx
慣	grxq
悺	grxs
悹	grxt
窤	grxu
鳏	gry
鰥	gryq
鳤	grys
鱞	gryt
鱹	gryu
遦	grzq
雚	grzs
躀	grzt
拱	gsa
拲	gsaq
公	gsb
共	gsbc
贡	gsbd
宫	gsbp
貢	gsbq
宮	gsbs
贛	gsbt
匑	gsbu
匔	gsbv
髸	gsbw
蚣	gsc
輁	gscq
汞	gse
澒	gseq
紅	gsfq
糼	gsfs
糿	gsft
工	gsg
巩	gsgc
廾	gsgd
弓	gsgp
鞏	gsgq
熕	gshq
杛	gsiq
栱	gsis
觥	gsj
幊	gsjq
銾	gsjs
觵	gsjt
兝	gskq
兣	gsks
篢	gskt
功	gsl
肱	gslc
龚	gslp
龔	gslq
龏	gsls
唝	gsoq
嗊	gsos
碽	gspq
躬	gss
厷	gssq
躳	gsss
塨	gstq
供	gsv
侊	gsvq
攻	gsw
珙	gswp
恭	gsx
愩	gsxq
慐	gsxs
羾	gsyq
扢	guaq
抇	guas
贾	gub
痼	gubp
賈	gubq
凅	gubs
蛊	guc
蛄	gucc
轱	gucp
蠱	gucq
軲	gucs
轂	guct
軱	gucu
沽	gue
汩	guep
泒	gueq
淈	gues
濲	guet
瀔	gueu
縎	gufq
骨	gug
鼓	gugc
谷	gugp
鼔	gugq
稒	guhq
穀	guhs
梏	gui
杚	guiq
柧	guis
棝	guit
榾	guiu
榖	guiv
橭	guiw
櫎	guix
钴	guj
锢	gujc
觚	gujp
鈷	gujq
錮	gujs
鈲	gujt
箍	guk
笟	gukq
箛	guks
篐	gukt
股	gul
臌	gulp
脵	gulq
瞽	gum
糓	gumq
盬	gums
姑	gun
鸪	gunc
牿	gund
鹄	gune
鹘	gunf
牯	gunp
鴣	gunq
鵠	guns
鶻	gunt
嫴	gunu
告	guo
咕	guoc
嘏	guod
古	guop
唂	guoq
唃	guos
啒	guot
嗗	guou
毂	gup
皷	gupq
磆	gups
皼	gupt
酤	guq
罟	gus
崮	gusp
罛	gusq
崓	guss
馉	gust
祻	gusu
餶	gusv
堌	gutq
菇	guu
菰	guup
苽	guuq
蓇	guus
薣	guut
估	guv
傦	guvq
僱	guvs
故	guw
固	guwp
辜	gux
怘	guxq
愲	guxs
顾	guy
鲴	guyc
诂	guyp
顧	guyq
詁	guys
鯝	guyt
羖	guyu
尳	guyv
鮕	guyw
孤	guz
雇	guzp
夃	guzq
逧	guzs
摫	gvaq
撌	gvas
贵	gvb
宄	gvbc
皈	gvbd
癸	gvbp
貴	gvbq
癐	gvbs
轨	gvc
軌	gvcq
軓	gvcs
蛫	gvct
厬	gvcu
螝	gvcv
蟡	gvcw
刽	gvd
刿	gvdp
劊	gvdq
劌	gvds
氿	gveq
湀	gves
溎	gvet
潙	gveu
匦	gvf
匭	gvfq
匱	gvfs
邽	gvft
陒	gvfu
郌	gvfv
鬼	gvg
庋	gvgc
龟	gvgp
龜	gvgq
庪	gvgs
廆	gvgt
鬶	gvgu
鬹	gvgv
鞼	gvgw
桂	gvi
桧	gvic
櫷	gvim
櫰	gvin
樻	gvio
柜	gvip
櫃	gviq
檜	gvis
朹	gvit
椝	gviu
椢	gviv
槼	gviw
槻	gvix
槶	gviy
槣	gviz
规	gvj
規	gvjq
帰	gvjs
觤	gvjt
鐀	gvju
鑎	gvjv
簋	gvk
袿	gvkq
筀	gvks
簂	gvkt
襘	gvku
胿	gvlq
闺	gvm
閨	gvmq
瞆	gvms
瞡	gvmt
瞶	gvmu
騩	gvmv
妫	gvn
媯	gvnq
姽	gvns
嫢	gvnt
鳺	gvnu
嬀	gvnv
硅	gvp
硊	gvpq
猤	gvqq
炅	gvr
晷	gvrp
昋	gvrq
祪	gvsq
嶡	gvss
嶲	gvst
禬	gvsu
巂	gvsv
圭	gvt
垝	gvtq
茥	gvuq
蓕	gvus
蘬	gvut
佹	gvvq
亀	gvvs
瑰	gvw
珪	gvwq
璝	gvws
瓌	gvwt
归	gvx
恑	gvxq
窐	gvxs
诡	gvy
鳜	gvyc
鲑	gvyp
詭	gvyq
鮭	gvys
鱖	gvyt
鱥	gvyu
跪	gvz
歸	gvzq
攰	gvzs
攱	gvzt
趹	gvzu
雟	gvzv
挂	gwa
掛	gwaq
寡	gwb
卦	gwbp
刮	gwd
剐	gwdp
剮	gwdq
劀	gwds
颪	gwfq
絓	gwfs
緺	gwft
颳	gwfu
瓜	gwg
煱	gwhq
栝	gwi
桰	gwiq
铦	gwjq
銛	gwjs
銽	gwjt
褂	gwk
袿	gwkq
胍	gwl
騧	gwmq
鸹	gwn
鴰	gwnq
呱	gwo
咼	gwoq
叧	gwos
啩	gwot
歄	gwqq
罣	gwsq
罫	gwss
冎	gwtq
坬	gwts
诖	gwy
詿	gwyq
諣	gwys
趏	gwzq
踻	gwzs
拐	gya
掴	gyap
摑	gyaq
夬	gydq
枴	gyiq
柺	gyis
箉	gykq
乖	gyp
罫	gysq
怪	gyx
恠	gyxq
叏	gyyq
挭	gzaq
賡	gzbq
刯	gzdq
浭	gzeq
耿	gzf
绠	gzfp
綆	gzfq
郠	gzfs
絙	gzft
絚	gzfu
縆	gzfv
緪	gzfw
庚	gzg
赓	gzgp
骾	gzgq
更	gzh
焿	gzhq
梗	gzi
椩	gziq
耕	gzl
鹒	gznq
鶊	gzns
哽	gzo
暅	gzrq
峺	gzsq
埂	gzt
畊	gztq
堩	gzts
莄	gzuq
菮	gzus
羹	gzy
鲠	gzyp
頸	gzyq
鯁	gzys
羮	gzyt
蛤	hac
蝦	hacq
奤	hadq
紦	hafq
铪	haj
鉿	hajq
哈	hao
乤	havq
皓	hcb
皐	hcbq
皞	hcbs
皜	hcbt
皡	hcbu
皥	hcbv
蚝	hcc
蠔	hccq
浩	hce
灏	hcec
濠	hcep
灝	hceq
淏	hces
滜	hcet
滈	hceu
澔	hcev
郝	hcf
鄗	hcfq
聕	hcfs
號	hchq
秏	hchs
椃	hciq
鎬	hcjq
兞	hckq
籇	hcks
耗	hcl
竓	hclq
毫	hcm
好	hcn
号	hco
嗥	hcoc
嚆	hcod
嚎	hcop
呺	hcoq
哠	hcos
噑	hcot
嘷	hcou
獆	hcqq
獔	hcqs
獋	hcqt
昊	hcr
昦	hcrq
晧	hcrs
暤	hcrt
暠	hcru
暭	hcrv
曍	hcrw
豪	hcs
壕	hct
蒿	hcu
薅	hcup
茠	hcuq
薧	hcus
薃	hcut
藃	hcuu
乚	hcvq
侴	hcvs
傐	hcvt
儫	hcvu
悎	hcxq
恏	hcxs
颢	hcy
顥	hcyq
諕	hcys
鰝	hcyt
譹	hcyu
貉	hcz
臯	hczq
拸	hdaq
害	hdb
海	hde
郂	hdfq
絯	hdfs
骸	hdg
烸	hdhq
胲	hdl
骇	hdm
駭	hdmq
駴	hdms
妎	hdnq
嗨	hdo
咍	hdoq
嗐	hdos
嚡	hdot
氦	hdq
醢	hdqp
猲	hdqq
酼	hdqs
餀	hdsq
饚	hdss
亥	hdt
塰	hdtq
还	hdz
孩	hdzp
還	hdzq
抲	heaq
贺	heb
賀	hebq
寉	hebs
癋	hebt
皬	hebu
赫	hec
蚵	hecp
龁	hecq
螛	hecs
齕	hect
蠚	hecu
河	hee
涸	heep
渮	heeq
澕	hees
紇	hefq
郃	hefs
鞨	hegq
禾	heh
焃	hehq
煂	hehs
熆	heht
熇	hehu
爀	hehv
燺	hehw
核	hei
柇	heiq
楁	heis
釛	hejq
鉌	hejs
鑉	hejt
褐	hek
袔	hekq
篕	heks
劾	hel
盒	hem
盍	hemc
阖	hemd
阂	hemp
閡	hemq
闔	hems
盇	hemt
籺	hemu
盉	hemv
粭	hemw
毼	hemx
麧	hemy
閤	hemz
鹤	hen
鶴	henq
鵠	hens
姀	hent
鹖	henu
穒	henv
鶡	henw
鶮	henx
鸖	heny
和	heo
呵	heoc
喝	heod
嗬	heoe
合	heop
嚇	heoq
咼	heos
咊	heot
哬	heou
啝	heov
喛	heow
嗃	heox
噈	heoy
碋	hepq
礉	heps
狢	heqq
欱	heqs
猲	heqt
曷	her
朅	herq
靍	hers
靎	hert
靏	heru
峆	hesq
饸	hess
餄	hest
餲	hesu
壑	het
垎	hetq
荷	heu
菏	heup
蓋	heuq
萂	heus
何	hev
佫	hevq
敆	hewq
惒	hexq
覈	hexs
诃	hey
翮	heyc
颌	heyp
訶	heyq
頜	heys
訸	heyt
鲄	heyu
詥	heyv
魺	heyw
翯	heyx
謞	heyy
龢	heyz
貉	hez
隺	hezq
貈	hezs
瘊	hfb
齁	hfbq
厚	hfc
後	hfcp
洉	hfeq
郈	hffq
鄇	hffs
骺	hfg
帿	hfjq
銗	hfjs
鍭	hfjt
篌	hfk
糇	hfm
睺	hfmq
后	hfo
喉	hfoc
吼	hfop
吽	hfoq
呴	hfos
猴	hfq
犼	hfqq
矦	hfsq
豞	hfss
餱	hfst
堠	hft
垕	hftq
茩	hfuq
葔	hfus
候	hfv
侯	hfvp
鲎	hfy
鱟	hfyq
鲘	hfys
翭	hfyt
鮜	hfyu
翵	hfyv
鯸	hfyw
逅	hfz
拫	hgaq
痕	hgb
很	hgc
鵆	hgcq
鞎	hggq
噷	hgoq
狠	hgq
佷	hgvq
恨	hgx
詪	hgyq
貥	hhbq
行	hhc
蚢	hhcq
夯	hhd
沆	hhe
绗	hhf
絎	hhfq
邟	hhfs
斻	hhft
骯	hhgq
杭	hhi
笐	hhkq
裄	hhks
筕	hhkt
妔	hhnq
吭	hho
垳	hhtq
苀	hhuq
忼	hhxq
颃	hhy
頏	hhyq
魧	hhys
航	hhz
迒	hhzq
掍	hkaq
轋	hkcq
殙	hkdq
混	hke
溷	hkec
浑	hkep
渾	hkeq
湣	hkes
涽	hket
湷	hkeu
魂	hkg
焄	hkhq
焝	hkhs
棔	hkiq
觨	hkjq
阍	hkm
閽	hkmq
眃	hkms
睧	hkmt
睴	hkmu
睯	hkmv
婚	hkn
婫	hknq
昏	hkr
昬	hkrq
馄	hks
餛	hksq
餫	hkss
鼲	hkst
荤	hku
葷	hkuq
蔒	hkus
俒	hkvq
倱	hkvs
珲	hkw
琿	hkwq
圂	hkws
忶	hkxq
惛	hkxs
惽	hkxt
尡	hkxu
慁	hkxv
诨	hky
諢	hkyq
撼	hla
撖	hlac
捍	hlap
扞	hlaq
寒	hlb
鼾	hlbp
兯	hlbq
皔	hlbs
蚶	hlc
厈	hlcq
虷	hlcs
蛿	hlct
蜭	hlcu
蜬	hlcv
輚	hlcw
螒	hlcx
汉	hle
涵	hlec
瀚	hled
汗	hlep
漢	hleq
汵	hles
涆	hlet
浛	hleu
浫	hlev
澏	hlew
邯	hlf
邗	hlfp
甝	hlgq
谽	hlgs
豃	hlgt
焊	hlh
焓	hlhp
熯	hlhq
梒	hliq
椷	hlis
釬	hljq
銲	hljs
鋡	hljt
鋎	hlju
函	hlk
凾	hlkq
笒	hlks
筨	hlkt
肣	hllq
罕	hlm
阚	hlmp
闞	hlmq
闬	hlms
閈	hlmt
睅	hlmu
馯	hlmv
駻	hlmw
娢	hlnq
鳱	hlns
嫨	hlnt
鶾	hlnu
含	hlo
喊	hlop
哻	hloq
唅	hlos
酣	hlq
犴	hlqp
猂	hlqq
歛	hlqs
旱	hlr
晗	hlrp
晘	hlrq
暵	hlrs
屽	hlsq
崡	hlss
嵅	hlst
垾	hltq
菡	hlu
莟	hluq
蔊	hlus
仠	hlvq
佄	hlvs
傼	hlvt
韩	hlw
韓	hlwq
攼	hlws
圅	hlwt
琀	hlwu
悍	hlx
憨	hlxc
憾	hlxp
忓	hlxq
馠	hlxs
翰	hly
颔	hlyc
顸	hlyp
頇	hlyq
頷	hlys
魽	hlyt
顄	hlyu
譀	hlyv
爳	hlzq
雗	hlzs
攉	hoa
捇	hoaq
掝	hoas
擭	hoat
货	hob
貨	hobq
癨	hobs
蠖	hoc
劐	hod
剨	hodq
奯	hods
活	hoe
沎	hoeq
湱	hoes
漷	hoet
濩	hoeu
濊	hoev
瀖	hoew
邩	hofq
或	hog
豁	hogp
韄	hogq
火	hoh
灬	hohp
秮	hohq
秳	hohs
秴	hoht
煷	hohu
穫	hohv
檴	hoiq
钬	hoj
镬	hojc
锪	hojp
鈥	hojq
鍃	hojs
鑊	hojt
旤	hoju
篧	hokq
耠	hol
耯	holq
臛	hols
眓	homq
閄	homs
矆	homt
騞	homu
矐	homv
姡	honq
和	hoo
嚯	hoop
吙	hooq
咊	hoos
咟	hoot
喐	hoou
嚄	hoov
嚿	hoow
乊	hopq
礊	hops
獲	hoqq
霍	hor
曤	horq
靃	hors
祸	hos
禍	hosq
获	hou
藿	houp
蒦	houq
伙	hov
佸	hovq
俰	hovs
惑	hox
夥	hoxp
窢	hoxq
彟	hoxs
彠	hoxt
謋	hoyq
趏	hozq
雘	hozs
艧	hozt
潶	hpeq
黑	hph
黒	hphq
嘿	hpo
揘	hqaq
皇	hqb
癀	hqbp
宺	hqbq
皝	hqbs
皩	hqbt
蝗	hqc
蟥	hqcc
徨	hqcp
巟	hqcq
奛	hqdq
湟	hqe
潢	hqep
汻	hqeq
滉	hqes
兤	hqet
隍	hqf
縨	hqfq
黄	hqh
煌	hqhp
黃	hqhq
炾	hqhs
熀	hqht
熿	hqhu
穔	hqhv
爌	hqhw
楻	hqiq
榥	hqis
櫎	hqit
凰	hqj
幌	hqjp
锽	hqjq
鍠	hqjs
鎤	hqjt
鐄	hqju
簧	hqk
篁	hqkp
肓	hql
朚	hqlq
騜	hqmq
媓	hqnq
鷬	hqns
喤	hqoq
磺	hqp
獚	hqqq
晃	hqr
晄	hqrq
曂	hqrs
崲	hqsq
餭	hqss
塃	hqtq
堭	hqts
墴	hqtt
荒	hqu
葟	hquq
偟	hqvq
璜	hqw
瑝	hqwq
慌	hqx
惶	hqxc
恍	hqxp
怳	hqxq
衁	hqxs
愰	hqxt
谎	hqy
鳇	hqyp
謊	hqyq
鰉	hqys
詤	hqyt
諻	hqyu
韹	hqyv
鱑	hqyw
遑	hqz
艎	hqzq
趪	hqzs
换	hra
擐	hrap
換	hraq
攌	hras
宦	hrb
寰	hrbc
鬟	hrbd
痪	hrbp
瘓	hrbq
寏	hrbs
轘	hrcq
奂	hrd
奐	hrdq
涣	hre
浣	hrec
漶	hred
洹	hrep
渙	hreq
澣	hres
澴	hret
缓	hrf
缳	hrfc
郇	hrfp
緩	hrfq
繯	hrfs
絙	hrft
綄	hrfu
酄	hrfv
焕	hrh
煥	hrhq
烉	hrhs
桓	hri
梙	hriq
槵	hris
锾	hrj
鍰	hrjq
镮	hrjs
鐶	hrjt
肒	hrlq
睆	hrmq
瞏	hrms
阛	hrmt
糫	hrmu
闤	hrmv
驩	hrmw
鴅	hrnq
嬛	hrns
鹮	hrnt
鵍	hrnu
孉	hrnv
唤	hro
喚	hroq
喛	hros
嚾	hrot
欢	hrq
獾	hrqp
歡	hrqq
犿	hrqs
狟	hrqt
獂	hrqu
歓	hrqv
豢	hrs
峘	hrsq
嵈	hrss
豲	hrst
堚	hrtq
萑	hru
荁	hruq
萈	hrus
蒝	hrut
藧	hruu
环	hrw
圜	hrwp
環	hrwq
瑍	hrws
瓛	hrwt
患	hrx
愌	hrxq
懁	hrxs
懽	hrxt
幻	hry
鲩	hryp
鯇	hryq
羦	hrys
鰀	hryt
鯶	hryu
讙	hryv
还	hrz
逭	hrzp
還	hrzq
雈	hrzs
貆	hrzt
雚	hrzu
貛	hrzv
揈	hsaq
撔	hsas
宏	hsb
訇	hsbp
宖	hsbq
轰	hsc
虹	hscp
轟	hscq
軣	hscs
輷	hsct
鬨	hsdq
洪	hse
泓	hsep
汯	hseq
沗	hses
浲	hset
浤	hseu
渱	hsev
溄	hsew
渹	hsex
潂	hsey
澒	hsez
红	hsf
紅	hsfq
纮	hsfs
耾	hsft
紘	hsfu
紭	hsfv
綋	hsfw
弘	hsg
谹	hsgq
谼	hsgs
鞃	hsgt
谾	hsgu
彋	hsgv
烘	hsh
黉	hshp
黌	hshq
灴	hshs
焢	hsht
鈜	hsjq
鉷	hsjs
銾	hsjt
鋐	hsju
鍧	hsjv
篊	hskq
竑	hslq
竤	hsls
闳	hsm
閎	hsmq
粠	hsms
閧	hsmt
闂	hsmu
闀	hsmv
鸿	hsn
鴻	hsnq
妅	hsns
娂	hsnt
哄	hso
叿	hsoq
呍	hsos
吰	hsot
吽	hsou
唝	hsov
嗊	hsow
嚝	hsox
硔	hspq
硡	hsps
晎	hsrq
霐	hsrs
霟	hsrt
厷	hssq
屸	hsss
巆	hsst
垬	hstq
荭	hsu
薨	hsuc
蕻	hsup
葒	hsuq
苰	hsus
葓	hsut
仜	hsvq
玒	hswq
瓨	hsws
玜	hswt
愩	hsxq
慐	hsxs
讧	hsy
訌	hsyq
羾	hsys
翃	hsyt
翝	hsyu
魟	hsyv
护	hua
抇	huaq
搰	huas
摢	huat
冱	hub
寣	hubq
鬍	hubs
蝴	huc
轷	hucp
軤	hucq
衚	hucs
螜	huct
湖	hue
浒	huec
滹	hued
沪	huep
滬	hueq
滸	hues
沍	huet
汻	hueu
泘	huev
淲	huew
淴	huex
濩	huey
瀫	huez
匢	hufq
匫	hufs
絗	huft
綔	hufu
鄠	hufv
縎	hufw
縠	hufx
弧	hug
瓠	hugp
戲	hugq
弖	hugs
瓡	hugt
戯	hugu
戱	hugv
虎	huh
户	huhc
虍	huhd
戽	huhe
烀	huhf
扈	huhg
煳	huhh
互	huhp
戶	huhq
戸	huhs
虖	huht
焀	huhu
虝	huhv
熩	huhw
槲	hui
枑	huiq
楛	huis
楜	huit
槴	huiu
斛	huj
帍	hujq
幠	hujs
錿	hujt
鍸	huju
鍙	hujv
觷	hujw
笏	huk
箶	hukq
簄	huks
胡	hul
膴	hulq
糊	hum
粐	humq
鹄	hun
鹘	hunc
鹱	hund
鶮	hunm
鶦	hunn
鳸	huno
鹕	hunp
鵠	hunq
鶘	huns
鶻	hunt
鸌	hunu
姱	hunv
婟	hunw
媩	hunx
嫮	huny
嫭	hunz
和	huo
唬	huoc
唿	huod
呼	huop
咊	huoq
喖	huos
嗀	huot
嗃	huou
嘑	huov
嘝	huow
嚛	huox
乎	hup
觳	hupp
乕	hupq
礐	hups
狐	huq
醐	huqc
猢	huqp
歑	huqq
昒	hurq
昈	hurs
曶	hurt
雽	huru
壶	hus
祜	husc
岵	husp
壺	husq
壷	huss
豰	hust
餬	husu
垀	hutq
葫	huu
芐	huuq
苸	huus
芔	huut
萀	huuu
蔛	huuv
蔰	huuw
乯	huvq
俿	huvs
僱	huvt
瑚	huw
琥	huwc
囫	huwp
瓳	huwq
忽	hux
惚	huxc
怙	huxp
怘	huxq
恗	huxs
鱯	huyo
許	huyq
護	huys
魱	huyt
頶	huyu
謼	huyv
鯱	huyw
鰗	huyx
鳠	huyy
頀	huyz
隺	huzq
雐	huzs
挥	hva
揮	hvaq
拻	hvas
撝	hvat
贿	hvb
賄	hvbq
痐	hvbs
瘣	hvbt
寭	hvbu
辉	hvc
蛔	hvcc
虺	hvcd
蟪	hvce
徽	hvcp
輝	hvcq
蟲	hvcs
蚘	hvct
蛕	hvcu
蜖	hvcv
螝	hvcw
徻	hvcx
殨	hvdq
汇	hve
洄	hvep
潰	hveq
澮	hves
泋	hvet
洃	hveu
湏	hvev
滙	hvew
潓	hvex
濊	hvey
瀈	hvez
绘	hvf
隳	hvfc
缋	hvfp
匯	hvfq
繪	hvfs
繢	hvft
隓	hvfu
絵	hvfv
戲	hvgq
廆	hvgs
戯	hvgt
灰	hvh
烩	hvhc
秽	hvhp
燴	hvhq
穢	hvhs
煒	hvht
灳	hvhu
烠	hvhv
烣	hvhw
煇	hvhx
燬	hvhy
桧	hvi
檜	hviq
楎	hvis
椲	hvit
槥	hviu
橞	hviv
檅	hviw
檓	hvix
櫘	hviy
幑	hvjq
銊	hvjs
鏸	hvjt
鐬	hvju
袆	hvkq
褘	hvks
篲	hvkt
麾	hvm
阓	hvmq
睳	hvms
瞺	hvmt
闠	hvmu
靧	hvmv
婎	hvnq
媈	hvns
嬒	hvnt
孈	hvnu
咴	hvo
喙	hvop
噅	hvoq
噦	hvos
嘒	hvot
噕	hvou
嚖	hvov
毁	hvp
毀	hvpq
毇	hvps
獩	hvqq
晦	hvr
晖	hvrp
會	hvrq
暉	hvrs
暳	hvrt
卉	hvs
屶	hvsq
屷	hvss
叀	hvst
豗	hvsu
禈	hvsv
餯	hvsw
墮	hvtq
囘	hvts
茴	hvu
蕙	hvuc
荟	hvup
薈	hvuq
芔	hvus
蔧	hvut
薉	hvuu
藱	hvuv
蘳	hvuw
会	hvv
佪	hvvq
僡	hvvs
儶	hvvt
回	hvw
珲	hvwp
琿	hvwq
囬	hvws
圚	hvwt
璤	hvwu
璯	hvwv
恢	hvx
悔	hvxc
惠	hvxd
恚	hvxe
彗	hvxf
慧	hvxp
恛	hvxq
恵	hvxs
彚	hvxt
彙	hvxu
憓	hvxv
懳	hvxw
讳	hvy
诙	hvyc
譿	hvyg
鰴	hvyh
顪	hvyi
譭	hvyj
譓	hvyk
翽	hvyl
鮰	hvym
頮	hvyn
翬	hvyo
诲	hvyp
誨	hvyq
諱	hvys
詼	hvyt
廻	hvyu
廽	hvyv
翙	hvyw
翚	hvyx
颒	hvyy
詯	hvyz
迴	hvzq
逥	hvzs
撶	hwaq
搳	hwas
摦	hwat
螖	hwcq
划	hwd
劃	hwdq
夻	hwds
滑	hwe
澅	hweq
繣	hwfq
黊	hwhq
桦	hwi
樺	hwiq
杹	hwis
枠	hwit
椛	hwiu
槬	hwiv
铧	hwj
鏵	hwjq
釪	hwjs
釫	hwjt
觟	hwju
錵	hwjv
鋘	hwjw
骅	hwm
驊	hwmq
糀	hwms
姡	hwnq
婲	hwns
婳	hwnt
嬅	hwnu
嫿	hwnv
鷨	hwnw
哗	hwo
嘩	hwoq
呚	hwos
吪	hwot
砉	hwp
硴	hwpq
磆	hwps
猾	hwq
华	hws
崋	hwsq
舙	hwss
画	hwt
畫	hwtq
埖	hwts
畵	hwtt
花	hwu
華	hwuq
芲	hwus
蕐	hwut
蘤	hwuu
化	hwv
话	hwy
話	hwyq
鮭	hwys
誮	hwyt
諣	hwyu
諙	hwyv
譁	hwyw
譮	hwyx
徊	hyc
劃	hydq
淮	hye
瀤	hyeq
槐	hyi
櫰	hyiq
褢	hykq
褱	hyks
耲	hylq
咶	hyoq
坏	hyt
壞	hytq
壊	hyts
蘾	hyuq
蘹	hyus
佪	hyvq
怀	hyx
懷	hyxq
懐	hyxs
踝	hyz
撗	hzaq
衡	hzc
涥	hzeq
烆	hzhq
横	hzi
桁	hzip
橫	hziq
鑅	hzjq
胻	hzlq
脝	hzls
姮	hznq
鸻	hzns
鴴	hznt
哼	hzo
啈	hzoq
亨	hzt
蘅	hzu
珩	hzw
恒	hzx
恆	hzxq
悙	hzxs
挲	iaa
挱	iaaq
摋	iaas
痧	iab
髿	iabq
厦	iac
刹	iad
剎	iadq
沙	iae
濈	iaeq
纱	iaf
紗	iafq
繺	iafs
廈	iagq
煞	iah
杀	iai
桬	iaiq
榝	iais
樧	iait
铩	iaj
鎩	iajq
帹	iajs
裟	iak
箑	iakq
粆	iamq
閯	iams
閷	iamt
啥	iao
唼	iaop
唦	iaoq
啑	iaos
喢	iaot
砂	iap
殺	iapq
硰	iaps
歃	iaq
猀	iaqq
霎	iar
莎	iau
萐	iauq
菨	iaus
蔱	iaut
傻	iav
乷	iavq
倽	iavs
儍	iavt
鲨	iay
鯊	iayq
翜	iays
翣	iayt
魦	iayu
鯋	iayv
歰	iazq
捎	ica
勺	icb
髾	icbq
蛸	icc
輎	iccq
潲	ice
绍	icf
邵	icfp
紹	icfq
旓	icfs
綤	icft
鞘	icg
弰	icgq
烧	ich
稍	ichp
燒	ichq
焼	ichs
梢	ici
杓	icip
柖	iciq
卲	icjq
筲	ick
袑	ickq
劭	icl
睄	icmq
娋	icnq
哨	ico
芍	icu
苕	icup
莦	icuq
萷	icus
蕱	icut
佋	icvq
玿	icwq
少	icx
韶	icy
鮹	icyq
艄	icz
摋	idaq
攦	idas
筛	idk
篩	idkq
簁	idks
簛	idkt
籭	idku
酾	idq
釃	idqq
晒	idr
曬	idrq
諰	idyq
摄	iea
揲	ieap
攝	ieaq
挕	ieas
捨	ieat
摂	ieau
赊	ieb
賒	iebq
賖	iebs
蛇	iec
厍	iecc
赦	iecp
厙	iecq
虵	iecs
蛥	iect
輋	iecu
蠂	iecv
奢	ied
奓	iedq
涉	iee
滠	ieep
灄	ieeq
泏	iees
渉	ieet
涻	ieeu
弽	iegq
檨	ieiq
欇	ieis
麝	iel
阇	iemq
闍	iems
騇	iemt
磼	iepq
猞	ieq
歙	ieqp
社	ies
舌	iesc
射	iesp
畲	iet
畬	ietq
畭	iets
蔎	ieuq
舍	iev
佘	ievp
舎	ievq
韘	iewq
慑	iex
懾	iexq
慴	iexs
设	iey
設	ieyq
手	ifa
扌	ifac
授	ifap
兽	ifb
瘦	ifbc
守	ifbp
痩	ifbq
寿	ifc
涭	ifeq
绶	iff
綬	iffq
鏉	ifjq
膄	iflq
售	ifo
嘼	ifoq
狩	ifq
獸	ifqq
獣	ifqs
首	ifs
壽	ifsq
夀	ifss
垨	iftq
乺	ifvq
收	ifw
敊	ifwq
受	ify
収	ifyq
艏	ifz
扟	igaq
抌	igas
搷	igat
审	igb
審	igbq
瘆	igbs
瘮	igbt
蜃	igc
蜄	igcq
深	ige
渗	igec
渖	iged
沈	igep
滲	igeq
瀋	iges
涁	iget
淰	igeu
兟	igev
绅	igf
紳	igfq
邥	igfs
弞	iggq
矤	iggs
甚	igh
燊	ighq
黮	ighs
椹	igi
罙	igiq
柛	igis
棯	igit
榊	igiu
鉮	igjq
幓	igjs
鋠	igjt
覾	igju
裑	igkq
申	igl
胂	iglc
肾	iglp
腎	iglq
脤	igls
糁	igm
糣	igmo
糝	igmq
籶	igms
冞	igmt
籸	igmu
眘	igmv
眒	igmw
糂	igmx
駪	igmy
瞫	igmz
婶	ign
娠	ignp
嬸	ignq
妽	igns
姺	ignt
嫀	ignu
鵢	ignv
呻	igo
哂	igop
砷	igp
氠	igqq
昚	igrq
曋	igrs
曑	igrt
身	igs
参	igsc
矧	igsd
神	igsp
參	igsq
屾	igss
峷	igst
甡	igsu
祳	igsv
叄	igsw
叅	igsx
罧	igsy
甧	igsz
堔	igtq
莘	igu
葚	igup
葠	iguq
蓡	igus
蔘	igut
薓	iguu
什	igv
伸	igvp
侁	igvq
侺	igvs
珅	igwq
敒	igws
慎	igx
穼	igxq
愼	igxs
诜	igy
讅	igyl
鰺	igym
鰰	igyn
鯵	igyo
谂	igyp
詵	igyq
諗	igys
谉	igyt
訠	igyu
訷	igyv
頣	igyw
魫	igyx
鲹	igyy
鯓	igyz
赏	ihb
賞	ihbq
贘	ihbs
螪	ihcq
殇	ihd
殤	ihdq
泷	ihe
湯	iheq
漡	ihes
滳	ihet
绱	ihf
緔	ihfq
鞝	ihgq
鬺	ihgs
上	ihh
熵	ihhp
丄	ihhq
扄	ihhs
樉	ihiq
觞	ihj
觴	ihjq
鋿	ihjs
鏛	ihjt
鑜	ihju
裳	ihk
商	iho
晌	ihr
禓	ihsq
墒	iht
垧	ihtp
埫	ihtq
蔏	ihuq
伤	ihv
傷	ihvq
尚	ihx
尙	ihxq
恦	ihxs
愓	ihxt
慯	ihxu
謪	ihyq
拾	iia
拭	iiap
揓	iiaq
实	iib
匙	iibc
贳	iibd
室	iibp
實	iibq
貰	iibs
実	iibt
宩	iibu
宲	iibv
痑	iibw
寔	iibx
释	iic
虱	iicc
轼	iicd
螫	iice
蚀	iicp
蝕	iicq
釋	iics
軾	iict
厔	iicu
釈	iicv
徥	iicw
蝨	iicx
失	iid
奭	iidq
湿	iie
澨	iieo
澤	iieq
濕	iies
兘	iiet
浉	iieu
湜	iiev
湤	iiew
溼	iiex
溡	iiey
溮	iiez
施	iif
邿	iifq
絁	iifs
事	iih
炻	iihc
世	iihp
丆	iihq
丗	iihs
亊	iiht
戺	iihu
烒	iihv
秲	iihw
煶	iihx
柿	iii
柹	iiiq
枾	iiis
栻	iiit
楴	iiiu
榁	iiiv
榯	iiiw
檡	iiix
市	iij
视	iijc
铈	iijd
鍦	iijm
銴	iijn
鉽	iijo
师	iijp
師	iijq
視	iijs
鈰	iijt
釶	iiju
觢	iijv
鉐	iijw
鉂	iijx
鉃	iijy
鉇	iijz
筮	iik
兙	iikq
笶	iiks
箷	iikt
褷	iiku
簭	iikv
籂	iikw
襫	iikx
襹	iiky
势	iil
勢	iilq
竍	iils
驶	iim
駛	iimq
眂	iims
冟	iimt
眎	iimu
眡	iimv
睗	iimw
馶	iimx
始	iin
鸤	iinq
姼	iins
鳲	iint
鳾	iinu
嬕	iinv
鶳	iinw
史	iio
嘘	iioc
嗜	iiod
噬	iiop
噓	iioq
呩	iios
呞	iiot
咶	iiou
啫	iiov
石	iip
屎	iipc
尸	iipp
屍	iipq
碩	iips
狮	iiq
獅	iiqq
釃	iiqs
狧	iiqt
狶	iiqu
醳	iiqv
是	iir
时	iirp
時	iirq
旹	iirs
昰	iirt
十	iis
示	iisc
食	iisd
氏	iise
饰	iisf
矢	iisg
饣	iish
礻	iisi
豕	iisj
舐	iisk
鼭	iisl
鼫	iism
餙	iisn
餝	iiso
士	iisp
飾	iisq
卋	iiss
飠	iist
峕	iisu
祏	iisv
崼	iisw
崻	iisx
嵵	iisy
舓	iisz
埘	iit
塒	iitq
埶	iits
畤	iitt
莳	iiu
蓍	iiup
蒔	iiuq
葹	iius
蒒	iiut
使	iiv
侍	iivc
什	iivd
仕	iivp
乭	iivq
乨	iivs
佦	iivt
瓧	iiwq
瑡	iiws
恃	iix
忕	iixq
忯	iixs
恀	iixt
惿	iixu
式	iiy
试	iiyc
诗	iiyd
誓	iiye
弑	iiyf
谥	iiyg
鲥	iiyh
鲺	iiyi
鰤	iiym
鰘	iiyn
諡	iiyo
识	iiyp
試	iiyq
詩	iiys
識	iiyt
弒	iiyu
謚	iiyv
鯴	iiyw
鰣	iiyx
鮖	iiyy
諟	iiyz
适	iiz
逝	iizp
適	iizq
辻	iizs
遈	iizt
遾	iizu
鬊	ikbq
楯	ikiq
橓	ikis
瞬	ikm
眴	ikmq
瞚	ikms
瞤	ikmt
吮	iko
蕣	ikuq
顺	iky
順	ikyq
舜	ikz
擅	ila
摻	ilaq
撣	ilas
挻	ilat
掞	ilau
搧	ilav
赡	ilb
疝	ilbp
贍	ilbq
痁	ilbs
蟮	ilc
軕	ilcq
蟺	ilcs
删	ild
剡	ildp
刪	ildq
剼	ilds
汕	ile
潸	ilep
澘	ileq
潬	iles
灗	ilet
陕	ilf
鄯	ilfc
缮	ilfp
繕	ilfq
邖	ilfs
陝	ilft
縿	ilfu
扇	ilh
煽	ilhp
炶	ilhq
煔	ilhs
熌	ilht
穇	ilhu
杉	ili
栅	ilip
柵	iliq
椫	ilis
樿	ilit
檆	iliu
钐	ilj
釤	iljq
銏	iljs
幓	iljt
覢	ilju
鐥	iljv
衫	ilk
笘	ilkq
膳	ill
膻	illp
脠	illq
闪	ilm
骟	ilmp
閃	ilmq
騸	ilms
閄	ilmt
閊	ilmu
睒	ilmv
姗	iln
嬗	ilnp
姍	ilnq
善	ilo
單	iloq
嘇	ilos
磰	ilpq
狦	ilqq
歚	ilqs
晱	ilrq
山	ils
禪	ilsq
嶦	ilss
饍	ilst
埏	ilt
圸	iltq
墠	ilts
墡	iltt
苫	ilu
芟	ilup
傓	ilvq
僐	ilvs
儃	ilvt
珊	ilw
敾	ilwq
讪	ily
鱣	ilyo
鳝	ilyp
訕	ilyq
鱔	ilys
鯅	ilyt
謆	ilyu
羴	ilyv
羶	ilyw
譱	ilyx
鳣	ilyy
鱓	ilyz
舢	ilz
跚	ilzp
赸	ilzq
搠	ioa
洬	ioeq
烁	ioh
爍	iohq
槊	ioi
铄	ioj
鑠	iojq
銏	iojs
鎙	iojt
箾	iokq
朔	iol
矟	iomq
妁	ion
硕	iop
碩	iopq
欶	ioqq
獡	ioqs
蒴	iou
数	iow
數	iowq
愬	ioxq
说	ioy
說	ioyq
説	ioys
誰	ipyq
爽	iqd
瀧	iqeq
漺	iqes
灀	iqet
縔	iqfq
欆	iqiq
鏯	iqjq
骦	iqmq
騻	iqms
驦	iqmt
孀	iqn
孇	iqnq
鷞	iqns
鹴	iqnt
鸘	iqnu
礵	iqpq
霜	iqr
塽	iqtq
慡	iqxq
双	iqy
雙	iqzq
艭	iqzs
拴	ira
涮	ire
絟	irfq
栓	iri
槫	iriq
腨	irlq
闩	irm
閂	irmq
抒	iua
摅	iuap
攄	iuaq
捒	iuas
捈	iuat
掓	iuau
赎	iub
贖	iubq
癙	iubs
输	iuc
蜀	iucp
術	iucq
輸	iucs
軗	iuct
尌	iucu
蠴	iucv
殊	iud
豎	iudq
鼡	iuds
淑	iue
沭	iuec
澍	iued
漱	iuep
潄	iueq
潻	iues
濖	iuet
瀭	iueu
纾	iuf
紓	iufq
陎	iufs
鄃	iuft
隃	iufu
絉	iufv
綀	iufw
緰	iufx
庶	iug
戍	iugp
庻	iugq
熟	iuh
秫	iuhc
黍	iuhp
焂	iuhq
稌	iuhs
虪	iuht
术	iui
束	iuic
梳	iuid
枢	iuie
树	iuip
樞	iuiq
樹	iuis
朮	iuit
杸	iuiu
橾	iuiv
鉥	iujq
錰	iujs
鏣	iujt
裋	iukq
襡	iuks
襩	iukt
籔	iuku
竖	iul
腧	iulc
丨	iulp
竪	iulq
毹	ium
毺	iumq
糬	iums
姝	iun
婌	iunq
鶐	iuns
鵨	iunt
咰	iuoq
属	iup
殳	iupp
屬	iupq
暑	iur
曙	iurp
書	iurq
兪	iurs
暏	iurt
霔	iuru
鼠	ius
署	iusp
墅	iut
塾	iutp
蔬	iuu
菽	iuuc
薯	iuup
荗	iuuq
蒁	iuus
蒣	iuut
薥	iuuu
藷	iuuv
书	iuv
俞	iuvc
倏	iuvd
舒	iuvp
侸	iuvq
倐	iuvs
儵	iuvt
数	iuw
數	iuwq
琡	iuws
瑹	iuwt
璹	iuwu
恕	iux
尗	iuxq
忬	iuxs
怸	iuxt
怷	iuxu
悆	iuxv
叔	iuy
鮛	iuyq
鱰	iuys
述	iuz
孰	iuzc
疏	iuzp
疎	iuzq
踈	iuzs
跾	iuzt
挩	ivaq
捝	ivas
水	ive
氵	ivep
氺	iveq
涗	ives
涚	ivet
税	ivh
稅	ivhq
帨	ivjq
裞	ivkq
脽	ivlq
睡	ivm
娷	ivnq
祱	ivsq
谁	ivy
说	ivyp
說	ivyq
誰	ivys
説	ivyt
蜀	iwc
刷	iwd
耍	iwe
唰	iwo
誜	iwyq
摔	iya
蟀	iyc
缞	iyfq
縗	iyfs
帅	iyj
帥	iyjq
衰	iyk
卛	iysq
率	iyx
甩	iyy
貹	izbq
賸	izbs
剩	izd
斘	izdq
殅	izds
剰	izdt
渑	ize
澠	izeq
泩	izes
渻	izet
湦	izeu
绳	izf
聖	izfq
聲	izfs
繩	izft
阩	izfu
陞	izfv
陹	izfw
縄	izfx
繉	izfy
焺	izhq
枡	iziq
栍	izis
椉	izit
榺	iziu
橳	iziv
鉎	izjq
鍟	izjs
笙	izk
胜	izl
勝	izlq
竔	izls
省	izm
眚	izmc
盛	izmp
牲	izn
娍	iznq
鵿	izns
呏	izoq
升	izp
乘	izpp
乗	izpq
殸	izps
狌	izqq
晟	izr
昇	izrq
晠	izrs
曻	izrt
生	izs
甥	izsc
嵊	izsd
声	izsp
鼪	izsq
圣	izt
墭	iztq
苼	izuq
蕂	izus
偗	izvq
珄	izwq
琞	izws
憴	izxq
譝	izyq
掘	jga
抉	jgac
攫	jgad
撅	jgap
挗	jgaq
捔	jgas
撧	jgat
决	jgb
疦	jgbq
瘚	jgbs
厥	jgc
虳	jgcq
蚗	jgcs
蟨	jgct
蟩	jgcu
劂	jgd
刔	jgdq
決	jgeq
泬	jges
灍	jget
绝	jgf
絕	jgfq
絶	jgfs
繘	jgft
匷	jgfu
弡	jggq
髉	jggs
彏	jggt
爝	jgh
焳	jghq
熦	jghs
燋	jght
爑	jghu
穱	jghv
桷	jgi
橛	jgip
橜	jgiq
櫭	jgis
觉	jgj
镢	jgjc
觖	jgjp
覺	jgjq
鐝	jgjs
覐	jgjt
鈌	jgju
覚	jgjv
觮	jgjw
鐍	jgjx
觼	jgjy
钁	jgjz
袦	jgkq
臄	jglq
闕	jgmq
矞	jgms
駃	jgmt
矡	jgmu
妜	jgnq
鴃	jgns
鴂	jgnt
鷢	jgnu
嚼	jgo
噱	jgoc
噘	jgop
吷	jgoq
噊	jgos
砄	jgpq
屩	jgps
屫	jgpt
獗	jgq
欮	jgqq
玃	jgqs
崛	jgs
氒	jgsq
崫	jgss
嶡	jgst
嶥	jgsu
埆	jgtq
壆	jgts
蕨	jgu
芵	jguq
蕝	jgus
倔	jgv
亅	jgvq
傕	jgvs
珏	jgw
玨	jgwq
玦	jgws
斍	jgwt
瑴	jgwu
璚	jgwv
憰	jgxq
憠	jgxs
戄	jgxt
诀	jgy
矍	jgyc
谲	jgyp
訣	jgyq
譎	jgys
鱖	jgyt
叕	jgyu
誳	jgyv
爵	jgz
蹶	jgzc
孓	jgzp
孒	jgzq
赽	jgzs
趹	jgzt
趉	jgzu
爴	jgzv
蹷	jgzw
蹻	jgzx
躩	jgzy
貜	jgzz
技	jia
掎	jiac
挤	jiap
擠	jiaq
擊	jias
揤	jiat
摖	jiau
撠	jiav
撃	jiaw
撽	jiax
疾	jib
寄	jibc
冀	jibd
赍	jibe
瘠	jibf
髻	jibg
寂	jibp
賫	jibq
屰	jibs
皀	jibt
皍	jibu
痵	jibv
兾	jibw
賷	jibx
癠	jiby
癪	jibz
辑	jic
虮	jicp
輯	jicq
蟣	jics
彶	jict
徛	jicu
蝍	jicv
螏	jicw
轚	jicx
剂	jid
殛	jidc
剞	jidp
劑	jidq
刉	jids
刏	jidt
剤	jidu
济	jie
汲	jiec
洎	jied
瀱	jien
潗	jieo
激	jiep
濟	jieq
汥	jies
泲	jiet
済	jieu
淁	jiev
湒	jiew
漈	jiex
漃	jiey
濈	jiez
给	jif
级	jifc
继	jifd
际	jife
纪	jiff
绩	jifg
缉	jifh
繫	jifj
繋	jifk
隮	jifl
緁	jifm
綨	jifn
継	jifo
系	jifp
級	jifq
紀	jifs
給	jift
際	jifu
緝	jifv
績	jifw
繼	jifx
郆	jify
紒	jifz
既	jig
戢	jigc
戟	jigp
谻	jigq
庴	jigs
鬾	jigt
鞊	jigu
廭	jigv
鞿	jigw
魕	jigx
积	jih
丌	jihc
亟	jihd
嵇	jihe
稷	jihf
稽	jihp
積	jihq
焏	jihs
稘	jiht
稩	jihu
穊	jihv
穄	jihw
穖	jihx
穧	jihy
机	jii
棘	jiic
楫	jiid
檵	jiik
櫭	jiil
櫅	jiim
檕	jiin
檝	jiio
极	jiip
極	jiiq
機	jiis
枅	jiit
楖	jiiu
梞	jiiv
槉	jiiw
樭	jiix
槣	jiiy
橶	jiiz
几	jij
即	jijc
觊	jijd
鑙	jiji
鑇	jijj
鐖	jijk
鏶	jijl
韲	jijm
鍓	jijn
錤	jijo
己	jijp
覬	jijq
旡	jijs
卽	jijt
觙	jiju
帺	jijv
旣	jijw
銈	jijx
銡	jijy
觭	jijz
击	jik
箕	jikc
笈	jikd
笄	jike
籍	jikp
筓	jikq
裚	jiks
箿	jikt
襀	jiku
簎	jikv
簊	jikw
襋	jikx
肌	jil
麂	jilc
脊	jilp
丮	jilq
朞	jils
勣	jilt
耤	jilu
膌	jilv
耭	jilw
骑	jim
骥	jimp
驥	jimq
瞉	jims
鸡	jin
嫉	jinc
妓	jind
犄	jine
鸄	jinn
鷑	jino
姬	jinp
乁	jinq
妀	jins
姞	jint
鳮	jinu
鹡	jinv
鵋	jinw
鶏	jinx
鷄	jiny
鶺	jinz
吉	jio
咭	jioc
哜	jiod
唧	jioe
叽	jiop
嘰	jioq
嚌	jios
喞	jiot
嗘	jiou
及	jip
屐	jipc
矶	jipp
磯	jipq
硛	jips
毄	jipt
磼	jipu
齊	jiqq
齏	jiqs
犱	jiqt
齌	jiqu
齎	jiqv
霁	jir
暨	jirp
霽	jirq
暩	jirs
曁	jirt
霵	jiru
祭	jis
岌	jisc
嵴	jisd
羁	jise
羇	jisn
罽	jiso
饥	jisp
饑	jisq
羈	jiss
飢	jist
卙	jisu
嵆	jisv
禝	jisw
嶯	jisx
躸	jisy
禨	jisz
基	jit
畸	jitc
畿	jitd
墼	jite
圾	jitp
坖	jitq
垍	jits
畟	jitt
堲	jitu
塉	jitv
藉	jiu
芨	jiuc
芰	jiud
荠	jiue
蒺	jiuf
蕺	jiug
虀	jium
蘻	jiun
蘮	jiuo
蓟	jiup
茍	jiuq
薊	jius
薺	jiut
苙	jiuu
茤	jiuv
葪	jiuw
蔇	jiux
蕀	jiuy
蘎	jiuz
伎	jiv
佶	jivc
偈	jivd
乩	jivp
亼	jivq
亽	jivs
伋	jivt
偮	jivu
僟	jivv
玑	jiw
齑	jiwp
璣	jiwq
敧	jiws
璾	jiwt
急	jix
悸	jixc
覊	jixo
忌	jixp
彑	jixq
尐	jixs
忣	jixt
惎	jixu
愱	jixv
憿	jixw
懠	jixx
懻	jixy
覉	jixz
计	jiy
讥	jiyc
鲚	jiyd
鲫	jiye
諔	jiyi
諆	jiyj
諅	jiyk
誋	jiyl
魢	jiym
魥	jiyn
魝	jiyo
记	jiyp
計	jiyq
記	jiys
幾	jiyt
譏	jiyu
詰	jiyv
鯽	jiyw
鱭	jiyx
叝	jiyy
鱾	jiyz
集	jiz
季	jizc
跻	jizd
跽	jize
雧	jizk
躤	jizl
艥	jizm
蹟	jizn
蹐	jizo
迹	jizp
跡	jizq
雞	jizs
躋	jizt
攲	jizu
臮	jizv
趌	jizw
趞	jizx
踑	jizy
踖	jizz
拣	jja
搛	jjac
捡	jjap
揀	jjaq
撿	jjas
挸	jjat
揵	jjau
揃	jjav
擶	jjaw
攕	jjax
减	jjb
贱	jjbc
兼	jjbp
賤	jjbq
冿	jjbs
寋	jjbt
賎	jjbu
鬋	jjbv
徤	jjcq
螹	jjcs
蠒	jjct
轞	jjcu
剪	jjd
歼	jjdc
剑	jjdp
劍	jjdq
殲	jjds
剣	jjdt
剱	jjdu
劎	jjdv
劒	jjdw
劔	jjdx
殱	jjdy
渐	jje
涧	jjec
湔	jjed
瀽	jjen
瀸	jjeo
溅	jjep
淺	jjeq
減	jjes
漸	jjet
澗	jjeu
濺	jjev
洊	jjew
湕	jjex
瀐	jjey
瀳	jjez
缄	jjf
缣	jjfp
緘	jjfq
繭	jjfs
縑	jjft
旔	jjfu
絸	jjfv
繝	jjfw
聻	jjfx
艰	jjg
戬	jjgc
鞯	jjgd
韀	jjgo
戋	jjgp
艱	jjgq
戔	jjgs
戩	jjgt
韉	jjgu
幵	jjgv
靬	jjgw
弿	jjgx
彅	jjgy
鞬	jjgz
煎	jjh
稴	jjhq
熞	jjhs
熸	jjht
检	jji
槛	jjic
枧	jjid
楗	jjie
櫼	jjin
橏	jjio
柬	jjip
檢	jjiq
檻	jjis
梘	jjit
栫	jjiu
検	jjiv
椷	jjiw
椾	jjix
榗	jjiy
樫	jjiz
见	jjj
鉴	jjjc
锏	jjjd
鐗	jjji
鏩	jjjj
覵	jjjk
覸	jjjl
鎫	jjjm
鍳	jjjn
鋻	jjjo
键	jjjp
見	jjjq
鍵	jjjs
鑒	jjjt
鐧	jjju
帴	jjjv
釰	jjjw
釼	jjjx
鋄	jjjy
鋑	jjjz
简	jjk
笺	jjkc
笕	jjkd
裥	jjke
襺	jjko
箭	jjkp
箋	jjkq
簡	jjks
筧	jjkt
襇	jjku
袸	jjkv
篯	jjkw
襉	jjkx
籈	jjky
籛	jjkz
肩	jjl
腱	jjlp
鹹	jjlq
鹼	jjls
麉	jjlt
鹸	jjlu
鹻	jjlv
间	jjm
睑	jjmc
毽	jjmd
监	jjmp
間	jjmq
監	jjms
瞼	jjmt
閒	jjmu
睷	jjmv
糋	jjmw
瞷	jjmx
瞯	jjmy
奸	jjn
犍	jjnc
鹣	jjnd
牮	jjnp
鵑	jjnq
鶼	jjns
姧	jjnt
姦	jjnu
鳽	jjnv
鵳	jjnw
囏	jjoq
碱	jjp
硷	jjpp
牋	jjpq
碊	jjps
磵	jjpt
礀	jjpu
礆	jjpv
礛	jjpw
礷	jjpx
猏	jjqq
朁	jjrq
暕	jjrs
饯	jjs
餞	jjsq
豜	jjss
豣	jjst
餰	jjsu
坚	jjt
堅	jjtq
堿	jjts
塹	jjtt
墹	jjtu
荐	jju
菅	jjuc
蒹	jjud
茧	jjup
薦	jjuq
菺	jjus
葌	jjut
蔪	jjuu
蕳	jjuv
蕑	jjuw
藆	jjux
虃	jjuy
件	jjv
俭	jjvc
僭	jjvd
健	jjvp
儉	jjvq
俴	jjvs
倹	jjvt
傔	jjvu
僣	jjvv
囝	jjw
玪	jjwq
珔	jjws
瑊	jjwt
瑐	jjwu
尖	jjx
惤	jjxq
馢	jjxs
建	jjy
谫	jjyc
鲣	jjyd
翦	jjye
謇	jjyf
鰜	jjym
譼	jjyn
鰔	jjyo
谏	jjyp
諫	jjyq
鰹	jjys
譾	jjyt
詃	jjyu
諓	jjyv
鳒	jjyw
謭	jjyx
鰎	jjyy
譛	jjyz
践	jjz
踺	jjzc
蹇	jjzd
舰	jjzp
踐	jjzq
艦	jjzs
雃	jjzt
臶	jjzu
跈	jjzv
趝	jjzw
捃	jka
攈	jkaq
攟	jkas
賐	jkbq
寯	jkbs
軍	jkcq
蚐	jkcs
蜠	jkct
浚	jke
汮	jkeq
濬	jkes
郡	jkf
陖	jkfq
龜	jkgq
焌	jkhq
燇	jkhs
桾	jkiq
棞	jkis
钧	jkj
鈞	jkjq
銁	jkjs
銞	jkjt
覠	jkju
鍕	jkjv
筠	jkk
袀	jkkq
箟	jkks
箘	jkkt
竣	jkl
麇	jklp
麏	jklq
麕	jkls
军	jkm
骏	jkmp
駿	jkmq
姰	jknq
鵔	jkns
鵘	jknt
鵕	jknu
君	jko
呁	jkoq
皲	jkp
皸	jkpq
碅	jkps
皹	jkpt
晙	jkrq
峻	jks
馂	jksq
餕	jkss
均	jkt
埈	jktq
畯	jkts
菌	jku
莙	jkuq
葰	jkus
俊	jkv
儁	jkvq
珺	jkwq
懏	jkxq
鲪	jkyq
頵	jkys
鮶	jkyt
雋	jkzq
鐱	jljq
鑑	jljs
鑯	jljt
鑳	jlju
鑬	jljv
搅	jma
挢	jmap
攪	jmaq
撟	jmas
挍	jmat
捁	jmau
摎	jmav
摷	jmaw
撹	jmax
皎	jmb
賋	jmbq
癄	jmbs
皦	jmbt
皭	jmbu
较	jmc
蛟	jmcc
徼	jmcd
轿	jmcp
較	jmcq
轎	jmcs
徺	jmct
轇	jmcu
蟜	jmcv
蟭	jmcw
剿	jmd
斠	jmdq
劋	jmds
浇	jme
湫	jmep
澆	jmeq
湬	jmes
滘	jmet
漖	jmeu
潐	jmev
灂	jmew
灚	jmex
绞	jmf
缴	jmfc
郊	jmfp
絞	jmfq
繳	jmfs
焦	jmh
烄	jmhq
煍	jmhs
虠	jmht
燋	jmhu
穚	jmhv
校	jmi
椒	jmip
樔	jmiq
角	jmj
铰	jmjp
鉸	jmjq
覺	jmjs
覐	jmjt
釥	jmju
覚	jmjv
鐎	jmjw
笅	jmkq
筊	jmks
簥	jmkt
脚	jml
胶	jmlp
腳	jmlq
膠	jmls
勦	jmlt
膲	jmlu
骄	jmm
驕	jmmq
娇	jmn
鹪	jmnc
姣	jmnp
嬌	jmnq
鷦	jmns
嬓	jmnt
鵁	jmnu
孂	jmnv
鷮	jmnw
叫	jmo
噍	jmoc
嚼	jmop
喬	jmoq
呌	jmos
嘂	jmot
嘄	jmou
嘦	jmov
嘐	jmow
噭	jmox
礁	jmp
狡	jmq
醮	jmqc
酵	jmqp
獥	jmqq
釂	jmqs
晈	jmrq
暞	jmrs
曒	jmrt
矫	jms
峤	jmsc
饺	jmsp
餃	jmsq
矯	jmss
嶠	jmst
峧	jmsu
嶕	jmsv
嶣	jmsw
交	jmt
蕉	jmu
茭	jmuc
艽	jmup
茮	jmuq
藠	jmus
侥	jmv
僬	jmvc
佼	jmvp
僥	jmvq
儌	jmvs
教	jmw
敫	jmwp
珓	jmwq
敎	jmws
斍	jmwt
敽	jmwu
敿	jmwv
璬	jmww
窖	jmx
恔	jmxq
悎	jmxs
窌	jmxt
憢	jmxu
憍	jmxv
憿	jmxw
鲛	jmy
鮫	jmyq
訆	jmys
譑	jmyt
譥	jmyu
鱎	jmyv
龣	jmyw
跤	jmz
臫	jmzq
踋	jmzs
趭	jmzt
揪	jna
捄	jnaq
揂	jnas
揫	jnat
摎	jnau
疚	jnb
鬏	jnbp
勼	jnbq
镹	jnbs
匓	jnbt
厩	jnc
齨	jncq
鬮	jndq
剹	jnds
殧	jndt
酒	jne
氿	jneq
汣	jnes
纠	jnf
糾	jnfq
匛	jnfs
糺	jnft
紤	jnfu
匶	jnfv
廄	jngq
廐	jngs
廏	jngt
灸	jnh
稵	jnhq
柩	jni
桕	jnip
朻	jniq
杦	jnis
柾	jnit
樛	jniu
欍	jniv
舅	jnj
韭	jnjc
臼	jnjp
舊	jnjq
韮	jnjs
丩	jnlq
麔	jnls
阄	jnm
鸠	jnn
鹫	jnnp
鳩	jnnq
鷲	jnns
牞	jnnt
奺	jnnu
咎	jno
啾	jnop
九	jnp
久	jnpp
乆	jnpq
旧	jnr
舏	jnsq
萛	jnuq
僦	jnv
乣	jnvq
倃	jnvs
救	jnw
玖	jnwp
究	jnx
慦	jnxq
就	jny
鯦	jnyq
赳	jnz
蹵	jnzq
摪	jqaq
摾	jqas
將	jqcq
螀	jqcs
螿	jqct
奖	jqd
豇	jqdp
奨	jqdq
奬	jqds
殭	jqdt
江	jqe
洚	jqec
浆	jqep
漿	jqeq
滰	jqes
降	jqf
绛	jqfc
缰	jqfd
匠	jqfp
絳	jqfq
匞	jqfs
繮	jqft
强	jqg
強	jqgq
韁	jqgs
弜	jqgt
弶	jqgu
彊	jqgv
桨	jqi
槳	jqiq
橿	jqis
櫤	jqit
耩	jql
勥	jqlq
膙	jqls
糨	jqm
糡	jqmq
姜	jqn
犟	jqnp
将	jqp
礓	jqpp
酱	jqq
靓	jqqp
獎	jqqq
醬	jqqs
醤	jqqt
嵹	jqsq
疆	jqt
畕	jqtq
塂	jqts
畺	jqtt
壃	jqtu
疅	jqtv
蒋	jqu
茳	jqup
蔣	jquq
葁	jqus
薑	jqut
僵	jqv
傋	jqvq
讲	jqy
講	jqyq
翞	jqys
鳉	jqyt
顜	jqyu
謽	jqyv
鱂	jqyw
夅	jqzq
捐	jra
捲	jraq
蠲	jrc
奆	jrdq
奍	jrds
涓	jre
淃	jreq
绢	jrf
鄄	jrfp
絹	jrfq
絭	jrfs
縳	jrft
弮	jrgq
鞙	jrgs
焆	jrhq
桊	jri
棬	jriq
梋	jris
椦	jrit
卷	jrj
镌	jrjc
锩	jrjp
錈	jrjq
鐫	jrjs
帣	jrjt
鋗	jrju
鋑	jrjv
鎸	jrjw
裐	jrkq
脧	jrlq
劵	jrls
勌	jrlt
朘	jrlu
腃	jrlv
勬	jrlw
臇	jrlx
眷	jrm
睊	jrmq
睠	jrms
闂	jrmt
娟	jrn
鹃	jrnp
鵑	jrnq
姢	jrns
婘	jrnt
呟	jroq
狷	jrq
獧	jrqq
巻	jrsq
罥	jrss
飬	jrst
嶲	jrsu
餋	jrsv
羂	jrsw
巂	jrsx
埍	jrtq
菤	jruq
蔨	jrus
倦	jrv
瓹	jrwq
圏	jrws
悁	jrxq
惓	jrxs
慻	jrxt
讂	jryq
隽	jrz
雋	jrzq
踡	jrzs
臦	jscq
臩	jscs
泂	jseq
浻	jses
澃	jset
絅	jsfq
綗	jsfs
炯	jsh
扃	jshp
扄	jshq
烱	jshs
煚	jsht
煛	jshu
熲	jshv
燛	jshw
銄	jsjq
褧	jskq
駉	jsmq
駫	jsms
冂	jst
坰	jstq
冋	jsts
冏	jstt
埛	jstu
蘏	jsuq
蘔	jsus
侰	jsvq
僒	jsvs
囧	jswq
窘	jsx
颎	jsyq
顈	jsys
迥	jsz
逈	jszq
接	jta
揭	jtac
拮	jtad
捷	jtap
扢	jtaq
掲	jtas
掶	jtat
搩	jtau
擑	jtav
擳	jtaw
擮	jtax
皆	jtb
疖	jtbc
疥	jtbp
癤	jtbq
痎	jtbs
镼	jtbt
街	jtc
蚧	jtcp
徣	jtcq
蛣	jtcs
蜐	jtct
蛶	jtcu
蝔	jtcv
蠞	jtcw
蠘	jtcx
蠽	jtcy
刦	jtdq
刧	jtds
刼	jtdt
洁	jte
潔	jteq
洯	jtes
湝	jtet
滐	jteu
结	jtf
阶	jtfp
階	jtfq
結	jtfs
斺	jtft
紒	jtfu
絜	jtfv
截	jtg
骱	jtgc
戒	jtgp
庎	jtgq
鞂	jtgs
鞊	jtgt
秸	jth
稭	jthq
煯	jths
杰	jti
桀	jtic
桔	jtip
杢	jtiq
桝	jtis
椄	jtit
楬	jtiu
楐	jtiv
楶	jtiw
榤	jtix
檞	jtiy
解	jtj
卩	jtjp
卪	jtjq
鉣	jtjs
觧	jtjt
幯	jtju
鍻	jtjv
鎅	jtjw
節	jtkq
衱	jtks
衸	jtkt
袓	jtku
袺	jtkv
裓	jtkw
褯	jtkx
劫	jtl
竭	jtlp
丯	jtlq
劼	jtls
脻	jtlt
耤	jtlu
睫	jtm
毑	jtmq
姐	jtn
婕	jtnp
妎	jtnq
媎	jtns
媘	jtnt
媫	jtnu
嫅	jtnv
犗	jtnw
鶛	jtnx
鶡	jtny
喈	jto
嗟	jtop
嚌	jtoq
吤	jtos
唶	jtot
啑	jtou
喼	jtov
届	jtp
碣	jtpp
屆	jtpq
砎	jtps
礍	jtpt
狤	jtqq
昅	jtrq
巀	jtso
岕	jtsq
岊	jtss
崨	jtst
嵑	jtsu
嵥	jtsv
飷	jtsw
嶱	jtsx
嶰	jtsy
嶻	jtsz
界	jtt
畍	jttq
堦	jtts
堺	jttt
节	jtu
芥	jtuc
藉	jtup
莭	jtuq
菨	jtus
蓵	jtut
介	jtv
借	jtvp
傑	jtvq
價	jtvs
倢	jtvt
偼	jtvu
玠	jtwq
瑎	jtws
琾	jtwt
尐	jtxq
悈	jtxs
诫	jty
诘	jtyc
颉	jtyd
鲒	jtye
羯	jtyf
讦	jtyp
誡	jtyq
訐	jtys
詰	jtyt
頡	jtyu
鮚	jtyv
魪	jtyw
誱	jtyx
謯	jtyy
孑	jtz
疌	jtzq
迼	jtzs
趌	jtzt
跲	jtzu
踕	jtzv
据	jua
拘	juac
掬	juad
拒	juap
據	juaq
抅	juas
拠	juat
捄	juau
挶	juav
挙	juaw
揟	juax
擧	juay
具	jub
疽	jubp
匊	jubq
寠	jubs
车	juc
龃	jucp
車	jucq
齟	jucs
蚷	juct
輂	jucu
蜛	jucv
螶	jucw
忂	jucx
举	jud
剧	judp
劇	judq
沮	jue
洰	jueq
泃	jues
泦	juet
淗	jueu
涺	juev
湨	juew
澽	juex
巨	juf
飓	jufc
聚	jufp
颶	jufq
巪	jufs
邭	juft
陱	jufu
郹	jufv
聥	jufw
繘	jufx
鞠	jug
鞫	jugp
弆	jugq
且	juh
炬	juhp
秬	juhq
焗	juhs
焣	juht
虡	juhu
桔	jui
椐	juic
榉	juid
榘	juie
橘	juif
枸	juip
櫃	juiq
櫸	juis
梮	juit
椇	juiu
椈	juiv
檋	juiw
欅	juix
锯	juj
锔	jujc
钜	jujp
舉	jujq
鋸	jujs
鉅	jujt
鋦	juju
凥	jujv
鐻	jujw
裾	juk
袓	jukq
筥	juks
簴	jukt
籧	juku
襷	jukv
耟	julq
腒	juls
勮	jult
驹	jum
驧	jumo
駒	jumq
眗	jums
毩	jumt
粔	jumu
毱	jumv
駏	jumw
閰	jumx
粷	jumy
駶	jumz
犋	jun
鶪	juno
姖	junq
娵	juns
婅	junt
婮	junu
犑	junv
鴡	junw
鵙	junx
鵴	juny
鶋	junz
句	juo
咀	juop
啹	juoq
局	jup
屦	jupc
居	jupp
屨	jupq
砠	jups
狙	juq
醵	juqp
狊	juqq
昛	jurq
矩	jus
岠	jusq
岨	juss
罝	just
崌	jusu
豦	jusv
躹	jusw
巈	jusx
鼰	jusy
鼳	jusz
埧	jutq
埾	juts
壉	jutt
菊	juu
苴	juuc
莒	juud
苣	juup
蒩	juuq
蒟	juus
蓻	juut
蘜	juuu
俱	juv
倨	juvp
乬	juvq
伡	juvs
俥	juvt
侷	juvu
倶	juvv
僪	juvw
琚	juw
珇	juwq
惧	jux
窭	juxp
懼	juxq
窶	juxs
怇	juxt
怚	juxu
怐	juxv
愳	juxw
懅	juxx
讵	juy
詎	juyq
鮔	juys
諊	juyt
鮈	juyu
距	juz
趄	juzc
雎	juzd
遽	juze
踽	juzf
躆	juzo
踞	juzp
歫	juzq
跙	juzs
跔	juzt
跼	juzu
艍	juzv
趜	juzw
踘	juzx
貗	juzy
蹫	juzz
侷	jvvq
挾	jwaq
扴	jwas
抸	jwat
拁	jwau
擖	jwav
家	jwb
痂	jwbc
瘕	jwbd
贾	jwbp
賈	jwbq
宊	jwbs
蛱	jwc
蛺	jwcq
徍	jwcs
徦	jwct
夹	jwd
夾	jwdq
斚	jwds
斝	jwdt
浃	jwe
浹	jweq
泇	jwes
郏	jwf
郟	jwfq
纐	jwfs
戛	jwg
戞	jwgq
稼	jwh
架	jwi
枷	jwip
梜	jwiq
椵	jwis
槚	jwit
榎	jwiu
榢	jwiv
檟	jwiw
钾	jwj
镓	jwjc
铗	jwjp
鉀	jwjq
鋏	jwjs
鎵	jwjt
幏	jwju
鉫	jwjv
笳	jwk
袈	jwkp
裌	jwkq
筴	jwks
加	jwl
胛	jwlp
耞	jwlq
脥	jwls
腵	jwlt
麚	jwlu
驾	jwm
駕	jwmq
毠	jwms
糘	jwmt
嫁	jwn
婽	jwnq
犌	jwns
鴐	jwnt
鴶	jwnu
鵊	jwnv
嘉	jwo
唊	jwoq
嗧	jwos
猰	jwqq
猳	jwqs
岬	jws
豭	jwsq
甲	jwt
圿	jwtq
埉	jwts
茄	jwu
葭	jwuc
荚	jwup
莢	jwuq
价	jwv
佳	jwvc
伽	jwvd
假	jwvp
價	jwvq
乫	jwvs
傢	jwvt
珈	jww
玾	jwwq
恝	jwx
忦	jwxq
颊	jwy
頰	jwyq
頡	jwys
叚	jwyt
頬	jwyu
迦	jwz
跏	jwzp
跲	jwzq
貑	jwzs
搢	jxaq
赆	jxb
贐	jxbq
寖	jxbs
凚	jxbt
賮	jxbu
厪	jxcq
齽	jxcs
殣	jxdq
津	jxe
浸	jxep
兓	jxeq
浕	jxes
溍	jxet
漌	jxeu
濅	jxev
濜	jxew
紧	jxf
缙	jxfp
緊	jxfq
縉	jxfs
紟	jxft
靳	jxg
廑	jxgp
烬	jxh
燼	jxhq
煡	jxhs
黅	jxht
槿	jxi
枃	jxiq
榗	jxis
金	jxj
巾	jxjc
斤	jxjd
钅	jxje
卺	jxjf
觐	jxjg
锦	jxjp
錦	jxjq
覲	jxjs
釒	jxjt
觔	jxju
釿	jxjv
筋	jxk
衿	jxkc
襟	jxkp
竻	jxkq
笒	jxks
劲	jxl
勁	jxlq
劤	jxls
鹶	jxlt
矜	jxm
盡	jxmq
矝	jxms
馸	jxmt
妗	jxn
婜	jxnq
嫤	jxns
嬐	jxnt
嬧	jxnu
噤	jxo
唫	jxoq
嚍	jxos
尽	jxp
砛	jxpq
歏	jxqq
晋	jxr
晉	jxrq
禁	jxs
馑	jxsp
巹	jxsq
饉	jxss
祲	jxst
堇	jxt
埐	jxtq
堻	jxts
墐	jxtt
壗	jxtu
荩	jxu
藎	jxuq
荕	jxus
菫	jxut
菳	jxuu
蓳	jxuv
今	jxv
仅	jxvp
僅	jxvq
仐	jxvs
伒	jxvt
侭	jxvu
僸	jxvv
儘	jxvw
瑾	jxw
珒	jxwq
琎	jxws
琻	jxwt
瑨	jxwu
璡	jxwv
璶	jxww
惍	jxxq
慬	jxxs
谨	jxy
謹	jxyq
进	jxz
近	jxzp
進	jxzq
臸	jxzs
擏	jyaq
净	jyb
痉	jybp
凈	jybq
痙	jybs
宑	jybt
径	jyc
徑	jycq
巠	jycs
蟼	jyct
荆	jyd
刭	jydp
剄	jydq
丼	jyds
殑	jydt
殌	jydu
泾	jye
涇	jyeq
汫	jyes
汬	jyet
浄	jyeu
淨	jyev
澋	jyew
瀞	jyex
经	jyf
旌	jyfc
阱	jyfp
經	jyfq
旍	jyfs
経	jyft
聙	jyfu
綡	jyfv
弪	jyg
弳	jygq
井	jyh
秔	jyhq
稉	jyhs
桱	jyiq
梷	jyis
橸	jyit
镜	jyj
鏡	jyjq
幜	jyjs
鋞	jyjt
兢	jyk
箐	jykp
竟	jyl
靖	jylc
肼	jyld
胫	jyle
腈	jylf
竞	jylp
勁	jylq
競	jyls
脛	jylt
劤	jylu
竫	jylv
竧	jylw
麖	jylx
竸	jyly
麠	jylz
精	jym
粳	jymc
睛	jymp
驚	jymq
粇	jyms
婧	jyn
妌	jynq
婙	jyns
婛	jynt
鵛	jynu
鶄	jynv
鶁	jynw
静	jyq
獍	jyqp
靜	jyqq
靚	jyqs
猄	jyqt
景	jyr
晶	jyrp
曔	jyrq
暻	jyrs
鼱	jysq
京	jyt
境	jytp
坓	jytq
坙	jyts
坕	jytt
亰	jytu
茎	jyu
菁	jyup
荊	jyuq
莖	jyus
葏	jyut
儆	jyv
俓	jyvq
倞	jyvs
傹	jyvt
敬	jyw
璄	jywq
璥	jyws
璟	jywt
惊	jyx
憬	jyxp
穽	jyxq
憼	jyxs
警	jyy
鲸	jyyc
颈	jyyp
頸	jyyq
鯨	jyys
誩	jyyt
頚	jyyu
迳	jyz
逕	jyzq
踁	jyzs
鮆	jzyq
鯚	jzys
譤	jzyt
鱀	jzyu
鰶	jzyv
桛	kaiq
鉲	kajq
裃	kakq
卡	kal
胩	kalp
咯	kao
咖	kaoc
咔	kaod
喀	kaop
垰	katq
鰿	kayq
拷	kca
洘	kceq
靠	kcf
髛	kcgq
烤	kch
丂	kchq
焅	kchs
熇	kcht
栲	kci
铐	kcj
銬	kcjq
考	kcl
犒	kcn
尻	kcp
嵪	kcsq
薧	kcuq
佧	kcv
攷	kcwq
鲓	kcyq
鮳	kcys
揩	kda
輆	kdcq
剀	kdd
豈	kddq
剴	kdds
奒	kddt
濭	kdeq
颽	kdfq
开	kdg
炌	kdhq
烗	kdhs
楷	kdi
凯	kdj
锎	kdjc
锴	kdjd
铠	kdjp
凱	kdjq
鍇	kdjs
鎧	kdjt
鐦	kdju
鎎	kdjv
勓	kdlq
開	kdmq
闿	kdms
闓	kdmt
嘅	kdoq
欯	kdqq
欬	kdqs
暟	kdrq
嵦	kdsq
垲	kdt
塏	kdtq
蒈	kdu
慨	kdx
恺	kdxc
忾	kdxp
愷	kdxq
愒	kdxs
鯌	kdyq
揢	keaq
搕	keas
客	keb
疴	kebp
痾	kebq
轲	kec
蝌	kecp
軻	kecq
尅	kecs
刻	ked
剋	kedq
渴	kee
溘	keep
渇	keeq
濭	kees
缂	kef
緙	kefq
匼	kefs
髁	keg
科	keh
稞	kehp
炣	kehq
棵	kei
柯	keip
榼	keiq
樖	keis
钶	kej
锞	kejp
鈳	kejq
鉿	kejs
錁	kejt
袔	kekq
勀	kelq
勊	kels
骒	kem
瞌	kemp
騾	kemq
騍	kems
閜	kemt
牱	kenq
娔	kens
犐	kent
可	keo
嗑	keoc
咳	keop
磕	kep
殼	kepq
牁	keps
砢	kept
殻	kepu
硞	kepv
磆	kepw
碦	kepx
礊	kepy
礚	kepz
氪	keq
欬	keqq
歁	keqs
醘	keqt
克	kes
岢	kesc
壳	kesp
峇	kesq
嵑	kess
嵙	kest
嶱	kesu
坷	ket
堁	ketq
苛	keu
萪	keuq
薖	keus
珂	kew
敤	kewq
恪	kex
窠	kexp
愾	kexq
悈	kexs
衉	kext
愘	kexu
愙	kexv
窼	kexw
课	key
颏	keyc
颗	keyp
課	keyq
顆	keys
頦	keyt
翗	keyu
趷	kezq
扣	kfa
抠	kfap
摳	kfaq
寇	kfb
宼	kfbq
剾	kfdq
滱	kfeq
彄	kfgq
釦	kfjq
筘	kfk
簆	kfkq
劶	kflq
竘	kfls
眍	kfm
瞘	kfmq
眗	kfms
冦	kfmt
瞉	kfmu
鷇	kfnq
口	kfo
叩	kfop
芤	kfu
蔻	kfup
蔲	kfuq
囗	kfw
敂	kfwq
怐	kfxq
艐	kfzq
掯	kgaq
龈	kgc
齦	kgcq
龂	kgcs
齗	kgct
錹	kgjq
裉	kgk
褃	kgkq
肯	kgl
肎	kglq
肻	kgls
啃	kgo
硍	kgpq
豤	kgsq
垦	kgt
墾	kgtq
珢	kgwq
恳	kgx
懇	kgxq
窛	kgxs
抗	kha
扛	khap
摃	khaq
漮	kheq
匟	khfq
邟	khfs
康	khg
炕	khh
穅	khhq
槺	khiq
钪	khj
鈧	khjq
鏮	khjs
糠	khm
闶	khmp
閌	khmq
粇	khms
嫝	khnq
砊	khpq
犺	khqq
嵻	khsq
躿	khss
亢	kht
伉	khv
囥	khwq
慷	khx
忼	khxq
貇	khzq
捆	kka
髡	kkb
髠	kkbq
髨	kkbs
蜫	kkcq
涃	kkeq
潉	kkes
綑	kkfq
稇	kkhq
焜	kkhs
稛	kkht
熴	kkhu
梱	kkiq
锟	kkj
錕	kkjq
裈	kkkq
裍	kkks
裩	kkkt
褌	kkku
阃	kkm
閫	kkmq
睏	kkms
閸	kkmt
騉	kkmu
婫	kknq
鹍	kkns
鵾	kknt
鶤	kknu
硱	kkpq
醌	kkq
猑	kkqq
昆	kkr
晜	kkrq
壸	kksq
崐	kkss
崑	kkst
祵	kksu
壼	kksv
坤	kkt
堒	kktq
堃	kkts
菎	kkuq
困	kkw
琨	kkwp
瑻	kkwq
悃	kkx
鲲	kky
鯤	kkyq
鱇	kkys
扻	klaq
衎	klcq
輡	klcs
轗	klct
刊	kld
鬫	kldq
戡	klg
槛	kli
檻	kliq
栞	klis
凵	klk
勘	kll
龛	kllp
龕	kllq
竷	klls
看	klm
瞰	klmc
阚	klmp
闞	klmq
冚	klms
矙	klmt
砍	klp
磡	klpq
欿	klqq
歁	klqs
崁	klsq
嵁	klss
堪	klt
坎	kltp
埳	kltq
墈	klts
莰	klu
侃	klv
偘	klvq
惂	klxq
貇	klzq
括	koa
扩	koap
擴	koaq
拡	koas
挄	koat
髺	kobq
鬠	kobs
蛞	koc
漷	koeq
濶	koes
廓	kog
鞟	kogq
鞹	kogs
秮	kohq
秳	kohs
铦	kojq
銛	kojs
銽	kojt
筈	kokq
阔	kom
闊	komq
噋	kooq
霩	korq
葀	kouq
萿	kous
韕	kowq
顑	koyq
尅	kpcq
頢	kpyq
抂	kqaq
况	kqb
贶	kqbp
貺	kqbq
卝	kqbs
軖	kqcq
軠	kqcs
軦	kqct
軭	kqcu
夼	kqd
剋	kqdq
況	kqeq
洭	kqes
匡	kqf
纩	kqfc
邝	kqfp
鄺	kqfq
纊	kqfs
邼	kqft
匩	kqfu
絋	kqfv
絖	kqfw
黋	kqhq
爌	kqhs
穬	kqht
框	kqi
鉱	kqjq
鋛	kqjs
鑛	kqjt
筐	kqk
筺	kqkq
丱	kqlq
劻	kqls
眶	kqm
眖	kqmq
矌	kqms
鵟	kqnq
哐	kqo
矿	kqp
礦	kqpq
砿	kqps
硄	kqpt
狂	kqq
狅	kqqq
旷	kqr
曠	kqrq
昿	kqrs
岲	kqsq
圹	kqt
壙	kqtq
儣	kqvq
忹	kqxq
恇	kqxs
懭	kqxt
懬	kqxu
诓	kqy
诳	kqyp
誆	kqyq
誑	kqys
宽	krb
寬	krbq
寛	krbs
髋	krg
髖	krgq
梡	kriq
鑧	krjq
臗	krlq
款	krq
欵	krqq
歀	krqs
窽	krxq
迋	krzq
控	ksa
涳	kseq
鞚	ksgq
椌	ksiq
錓	ksjq
箜	ksk
鵼	ksnq
矼	kspq
硿	ksps
崆	kss
躻	kssq
埪	kstq
倥	ksv
空	ksx
恐	ksxp
悾	ksxq
窾	ksxs
羫	ksyq
扝	kuaq
捁	kuas
搰	kuat
瘔	kubq
刳	kud
绔	kuf
絝	kufq
郀	kufs
库	kug
骷	kugp
庫	kugq
廤	kugs
秙	kuhq
焅	kuhs
枯	kui
桍	kuiq
楛	kuis
裤	kuk
褲	kukq
袴	kuks
朏	kulq
胐	kuls
哭	kuo
喾	kuop
嚳	kuoq
矻	kupq
硞	kups
酷	kuq
狜	kuqq
堀	kut
苦	kuu
俈	kuvq
圐	kuwq
窟	kux
窋	kuxq
鮬	kuyq
孔	kuz
揆	kva
蝰	kvc
奎	kvd
刲	kvdq
殨	kvds
溃	kve
潰	kveq
匮	kvf
聩	kvfc
隗	kvfp
匱	kvfq
聵	kvfs
鄈	kvft
聭	kvfu
聧	kvfv
魁	kvg
戣	kvgq
亏	kvh
虧	kvhq
煃	kvhs
楏	kviq
楑	kvis
櫆	kvit
鍷	kvjq
鍨	kvjs
篑	kvk
簣	kvkq
籄	kvks
胿	kvlq
膭	kvls
盔	kvm
睽	kvmp
骙	kvmq
瞆	kvms
瞶	kvmt
騤	kvmu
闚	kvmv
媿	kvnq
嬇	kvns
犪	kvnt
喹	kvo
喟	kvop
嘳	kvoq
磈	kvpq
暌	kvr
晆	kvrq
馈	kvs
馗	kvsc
岿	kvsp
饋	kvsq
巋	kvss
餽	kvst
巙	kvsu
葵	kvu
蒉	kvup
蕢	kvuq
藈	kvus
蘷	kvut
虁	kvuu
傀	kvv
愧	kvx
悝	kvxc
愦	kvxd
窥	kvxp
窺	kvxq
憒	kvxs
鮭	kvyq
尯	kvys
頍	kvyt
頯	kvyu
謉	kvyv
顝	kvyw
逵	kvz
夔	kvzc
跬	kvzp
歸	kvzq
跍	kvzs
蹞	kvzt
挎	kwa
夸	kwd
絓	kwfq
骻	kwgq
楇	kwiq
銙	kwjq
胯	kwl
姱	kwnq
咵	kwoq
晇	kwrq
垮	kwt
侉	kwv
恗	kwxq
誇	kwyq
跨	kwz
趶	kwzq
躨	kwzs
擓	kyaq
巜	kycq
蒯	kyd
浍	kye
澮	kyeq
郐	kyf
鄶	kyfq
旝	kyfs
廥	kygq
筷	kyk
凷	kykq
脍	kyl
膾	kylq
駃	kymq
糩	kyms
哙	kyo
噲	kyoq
狯	kyq
獪	kyqq
欳	kyqs
會	kyrq
块	kyt
塊	kytq
圦	kyts
墤	kytt
蕢	kyuq
会	kyv
侩	kyvp
儈	kyvq
璯	kywq
快	kyx
鲙	kyyq
舿	kyzq
挳	kzaq
揁	kzas
摼	kzat
阬	kzfq
铿	kzj
鏗	kzjq
銵	kzjs
鍞	kzjt
劥	kzlq
妔	kznq
牼	kzns
吭	kzo
硁	kzpq
殸	kzps
硜	kzpt
硻	kzpu
坑	kzt
坈	kztq
鱠	kzyq
拉	laa
揦	laaq
搚	laas
揧	laat
擸	laau
攋	laav
瘌	lab
癩	labq
鬎	labs
蜡	lac
蠟	lacq
蝋	lacs
蝲	lact
剌	lad
溂	laeq
鞡	lagq
爉	lahq
柆	laiq
楋	lais
櫴	lait
镴	lajq
鑞	lajs
腊	lal
臘	lalq
臈	lals
啦	lao
喇	laop
嚹	laoq
砬	lap
磖	lapq
旯	lar
垃	lat
落	lau
菈	lauq
藞	laus
瓎	lawq
辣	lax
辢	laxq
翋	layq
誙	lays
鯻	layt
捞	lca
撈	lcaq
痨	lcb
癆	lcbq
蛯	lccq
蟧	lccs
轑	lcct
涝	lce
潦	lcep
澇	lceq
浶	lces
絡	lcfq
髝	lcgq
烙	lch
栳	lci
橯	lciq
铑	lcj
铹	lcjp
銠	lcjq
鐒	lcjs
簩	lckq
老	lcl
耢	lclc
劳	lclp
勞	lclq
耮	lcls
耂	lclt
労	lclu
朥	lclv
閖	lcmq
粩	lcms
牢	lcn
姥	lcnp
嫪	lcnq
唠	lco
嘮	lcoq
咾	lcos
哰	lcot
嗠	lcou
硓	lcpq
磱	lcps
酪	lcq
醪	lcqp
狫	lcqq
崂	lcs
嶗	lcsq
躼	lcss
軂	lcst
荖	lcuq
佬	lcv
僗	lcvq
珯	lcwq
忉	lcx
恅	lcxq
窂	lcxs
憦	lcxt
憥	lcxu
鮱	lcyq
鱩	lcys
邋	lcz
攋	ldaq
赖	ldb
癞	ldbc
赉	ldbp
賴	ldbq
賚	ldbs
賫	ldbt
癘	ldbu
癩	ldbv
徕	ldc
徠	ldcq
涞	lde
濑	ldep
淶	ldeq
瀨	ldes
瀬	ldet
郲	ldfq
庲	ldgq
来	ldi
梾	ldiq
棶	ldis
櫴	ldit
铼	ldj
錸	ldjq
籁	ldk
籟	ldkq
筙	ldks
箂	ldkt
襰	ldku
勑	ldlq
睐	ldm
睞	ldmq
騋	ldms
麳	ldmt
娕	ldnq
婡	ldns
鵣	ldnt
鶆	ldnu
唻	ldoq
猍	ldqq
崃	lds
崍	ldsq
莱	ldu
萊	lduq
藾	ldus
來	ldvq
俫	ldvs
倈	ldvt
琜	ldwq
誺	ldyq
頼	ldys
顂	ldyt
鯠	ldyu
顟	ldyv
扐	leaq
泐	lee
氻	leeq
阞	lefq
樂	leiq
楽	leis
竻	lekq
簕	leks
勒	lel
牞	lenq
叻	leo
乐	lep
砳	lepq
饹	lesq
餎	less
艻	leuq
了	lev
仂	levp
玏	lewq
忇	lexq
鳓	ley
鰳	leyq
鱳	leys
逨	lezq
搂	lfa
摟	lfaq
瘘	lfb
瘺	lfbq
寠	lfbs
瘻	lfbt
蝼	lfc
螻	lfcq
漏	lfe
溇	lfeq
漊	lfes
陋	lff
髅	lfg
髏	lfgq
廔	lfgs
鞻	lfgt
熡	lfhq
楼	lfi
樓	lfiq
镂	lfj
鏤	lfjq
篓	lfk
簍	lfkq
耧	lfl
耬	lflq
瞜	lfmq
娄	lfn
婁	lfnq
鷜	lfns
喽	lfo
嘍	lfoq
屚	lfpq
露	lfr
嵝	lfs
嶁	lfsq
軁	lfss
塿	lftq
蒌	lfu
蔞	lfuq
偻	lfv
僂	lfvq
甊	lfwq
慺	lfxq
韷	lfyq
謱	lfys
遱	lfzq
艛	lfzs
掠	lga
寽	lgcq
稤	lghq
锊	lgj
鋝	lgjq
鋢	lgjs
略	lgt
畧	lgtq
貗	lgzq
螂	lhc
蜋	lhcq
浪	lhe
郎	lhf
郞	lhfq
郒	lhfs
廊	lhg
稂	lhh
烺	lhhq
榔	lhi
桹	lhiq
樃	lhis
鋃	lhjq
鎯	lhjs
筤	lhkq
朗	lhl
勆	lhlq
朖	lhls
朤	lhlt
阆	lhm
閬	lhmq
駺	lhms
嫏	lhnq
啷	lho
哴	lhoq
硠	lhpq
狼	lhq
欴	lhqq
崀	lhsq
躴	lhss
埌	lhtq
塱	lhts
蒗	lhu
蓈	lhuq
蓢	lhus
琅	lhw
瑯	lhwq
斏	lhws
圙	lhwt
誏	lhyq
扐	liaq
扚	lias
搮	liat
擽	liau
攊	liav
攦	liaw
攭	liax
痢	lib
疬	libc
疠	libp
癘	libq
癧	libs
凓	libt
鬁	libu
皪	libv
历	lic
厘	licc
轹	licd
蛎	lice
蜊	licf
蠡	licg
轣	lick
蠫	licl
蟸	licm
蠇	licn
蟍	lico
厉	licp
厲	licq
蠣	lics
轢	lict
蚸	licu
厤	licv
蛠	licw
厯	licx
蜧	licy
蝷	licz
利	lid
刕	lidq
剓	lids
剺	lidt
豊	lidu
劙	lidv
黎	lie
沥	liec
溧	lied
澧	liee
漓	liep
瀝	lieq
沴	lies
沵	liet
浬	lieu
浰	liev
涖	liew
濿	liex
灕	liey
郦	lif
缡	lifp
縭	lifq
酈	lifs
綟	lift
纅	lifu
纚	lifv
廲	ligq
瓥	ligs
丽	lih
黧	lihc
戾	lihp
秝	lihq
爄	lihs
爏	liht
穲	lihu
李	lii
梨	liic
枥	liid
栎	liie
欚	liij
欐	liik
櫔	liil
檪	liim
樆	liin
棃	liio
栗	liip
櫟	liiq
櫪	liis
朸	liit
杝	liiu
柂	liiv
栃	liiw
栛	liix
梸	liiy
棙	liiz
锂	lij
鋰	lijq
鎘	lijs
鉝	lijt
銐	liju
鋫	lijv
錅	lijw
鏫	lijx
觻	lijy
鑗	lijz
篱	lik
篥	likc
笠	likp
裏	likq
籬	liks
裡	likt
筣	liku
褵	likv
里	lil
立	lilc
隶	lild
励	lile
膦	lilf
力	lilp
勵	lilq
隸	lils
麗	lilt
脷	lilu
竰	lilv
隷	lilw
釐	lilx
麜	lily
粒	lim
粝	limc
骊	limp
糲	limq
驪	lims
睙	limt
睝	limu
粴	limv
盠	limw
糎	limx
盭	limy
犁	lin
鹂	linc
嫠	lind
孋	linn
鷅	lino
娌	linp
鸝	linq
娳	lins
婯	lint
犂	linu
鳨	linv
犛	linw
鴗	linx
犡	liny
鵹	linz
哩	lio
呖	lioc
唳	liod
喱	lioe
吏	liop
嚦	lioq
唎	lios
嚟	liot
囄	liou
囇	liov
砾	lip
砺	lipp
礫	lipq
礪	lips
砅	lipt
磿	lipu
礰	lipv
狸	liq
醴	liqc
猁	liqp
醨	liqq
雳	lir
靂	lirq
暦	lirs
曆	lirt
曞	liru
靋	lirv
礼	lis
罹	lisp
禮	lisq
屴	liss
岦	list
峛	lisu
峢	lisv
峲	lisw
巁	lisx
禲	lisy
离	lit
坜	litp
壢	litq
塛	lits
莉	liu
苈	liuc
莅	liud
蓠	liue
藜	liuf
荔	liup
蒞	liuq
藶	lius
蘺	liut
苙	liuu
茘	liuv
荲	liuw
菞	liux
蒚	liuy
蔾	liuz
例	liv
傈	livc
俪	livd
俚	live
俐	livp
儷	livq
儮	livs
理	liw
璃	liwp
珕	liwq
琍	liws
瓼	liwt
甅	liwu
瑮	liwv
瓈	liww
瓅	liwx
斄	liwy
瓑	liwz
悧	lixq
悡	lixs
悷	lixt
慄	lixu
鲤	liy
鲡	liyc
鳢	liyd
鱱	liyo
詈	liyp
鯉	liyq
鱧	liys
鱺	liyt
叓	liyu
叕	liyv
謧	liyw
鯏	liyx
鯬	liyy
讈	liyz
逦	liz
邌	lizn
歴	lizo
跞	lizp
貍	lizq
歷	lizs
離	lizt
邐	lizu
躒	lizv
迣	lizw
艃	lizx
艆	lizy
孷	lizz
摙	ljaq
鬑	ljbq
蠊	ljc
螊	ljcq
奁	ljd
殓	ljdp
奩	ljdq
殮	ljds
劆	ljdt
涟	lje
濂	ljec
潋	ljep
漣	ljeq
瀲	ljes
湅	ljet
溓	ljeu
澰	ljev
濓	ljew
瀮	ljex
联	ljf
纞	ljfo
练	ljfp
練	ljfq
聯	ljfs
匲	ljft
聨	ljfu
聫	ljfv
匳	ljfw
聮	ljfx
縺	ljfy
鄻	ljfz
廉	ljg
炼	ljh
煉	ljhq
熑	ljhs
稴	ljht
燫	ljhu
楝	lji
梿	ljiq
槤	ljis
槏	ljit
櫣	ljiu
檶	ljiv
链	ljj
镰	ljjc
帘	ljjp
鏈	ljjq
鐮	ljjs
覝	ljjt
錬	ljju
鍊	ljjv
鎌	ljjw
裢	ljk
裣	ljkp
簾	ljkq
褳	ljks
襝	ljkt
籢	ljku
籨	ljkv
脸	ljl
臁	ljlp
臉	ljlq
孌	ljnq
媡	ljns
嫾	ljnt
嬚	ljnu
嗹	ljoq
噒	ljos
磏	ljpq
歛	ljqq
醶	ljqs
堜	ljtq
亷	ljts
莲	lju
蔹	ljup
蓮	ljuq
薟	ljus
蘞	ljut
萰	ljuu
薕	ljuv
蘝	ljuw
僆	ljvq
敛	ljw
琏	ljwp
斂	ljwq
璉	ljws
瑓	ljwt
恋	ljx
怜	ljxp
憐	ljxq
戀	ljxs
慩	ljxt
鲢	ljy
鰱	ljyq
翴	ljys
謰	ljyt
羷	ljyu
鰊	ljyv
连	ljz
連	ljzq
赲	ljzs
抡	lka
掄	lkaq
轮	lkc
輪	lkcq
蜦	lkcs
沦	lke
淪	lkeq
溣	lkes
纶	lkf
綸	lkfq
陯	lkfs
稐	lkhq
棆	lkiq
錀	lkjq
腀	lklq
耣	lkls
婨	lknq
碖	lkpq
磮	lkps
崘	lksq
崙	lkss
埨	lktq
芲	lkuq
菕	lkus
伦	lkv
仑	lkvp
侖	lkvq
倫	lkvs
囵	lkw
圇	lkwq
惀	lkxq
论	lky
論	lkyq
鯩	lkys
蹥	lkzq
拦	lla
揽	llap
攔	llaq
攬	llas
擥	llat
兰	llb
厱	llcq
滥	lle
漤	llec
澜	llep
濫	lleq
瀾	lles
浨	llet
灆	lleu
灡	llev
灠	llew
缆	llf
纜	llfq
繿	llfs
韊	llgq
烂	llh
爛	llhq
燗	llhs
燷	llht
燣	llhu
爁	llhv
爤	llhw
爦	llhx
栏	lli
榄	llip
欄	lliq
欖	llis
欗	llit
览	llj
镧	lljp
覽	lljq
鑭	lljs
覧	lljt
幱	llju
钄	lljv
篮	llk
褴	llkp
籃	llkq
襤	llks
襕	llkt
襴	llku
籣	llkv
襽	llkw
阑	llm
闌	llmq
糷	llms
婪	lln
嬾	llnq
孄	llns
孏	llnt
嚂	lloq
囒	llos
囕	llot
醂	llqq
暕	llrq
岚	lls
罱	llsp
嵐	llsq
坔	lltq
壈	llts
壏	lltt
蓝	llu
藍	lluq
蘭	llus
葻	llut
蘫	lluu
儖	llvq
斓	llw
斕	llwq
璼	llws
瓓	llwt
懒	llx
懶	llxq
惏	llxs
懢	llxt
谰	lly
讕	llyq
譋	llys
顲	llyt
踚	llzq
撩	lma
撂	lmap
摎	lmaq
疗	lmb
寮	lmbc
寥	lmbp
療	lmbq
賿	lmbs
镽	lmbt
蟟	lmcq
蟧	lmcs
料	lmd
潦	lme
漻	lmeq
聊	lmf
缭	lmfp
繆	lmfq
繚	lmfs
鄝	lmft
飂	lmfu
飉	lmfv
廖	lmg
豂	lmgq
廫	lmgs
髎	lmgt
燎	lmh
炓	lmhq
爎	lmhs
爒	lmht
樛	lmiq
橑	lmis
镣	lmj
钌	lmjp
鐐	lmjq
釕	lmjs
簝	lmkq
膋	lmlq
膫	lmls
瞭	lmmq
鹩	lmn
鷯	lmnq
嫽	lmns
嘹	lmo
屪	lmpq
獠	lmq
暸	lmrq
嵺	lmsq
嶚	lmss
嶛	lmst
蓼	lmu
藔	lmuq
了	lmv
僚	lmvp
敹	lmwq
璙	lmws
窌	lmxq
尞	lmxs
憀	lmxt
憭	lmxu
窷	lmxv
竂	lmxw
尥	lmy
尦	lmyq
辽	lmz
遼	lmzq
蹽	lmzs
躝	lmzt
摎	lnaq
瘤	lnb
癅	lnbq
蟉	lncq
刘	lnd
劉	lndq
流	lne
浏	lnec
溜	lnep
瀏	lneq
漻	lnes
澑	lnet
绺	lnf
旒	lnfp
陸	lnfq
綹	lnfs
斿	lnft
旈	lnfu
飗	lnfv
飀	lnfw
飂	lnfx
飅	lnfy
廇	lngq
鬸	lngs
熘	lnh
熮	lnhq
柳	lni
榴	lnip
栁	lniq
桞	lnis
桺	lnit
橊	lniu
橮	lniv
锍	lnj
鎏	lnjc
镏	lnjp
鋶	lnjq
鎦	lnjs
镠	lnjt
鏐	lnju
鐂	lnjv
裗	lnkq
麍	lnlq
骝	lnm
騮	lnmq
駠	lnms
駵	lnmt
驑	lnmu
鹨	lnn
鷚	lnnq
媹	lnns
鹠	lnnt
嬼	lnnu
鶹	lnnv
嚠	lnoq
硫	lnp
磂	lnpq
磟	lnps
霤	lnrq
馏	lns
餾	lnsq
嵧	lnss
罶	lnst
羀	lnsu
六	lnt
留	lntp
畄	lntq
畱	lnts
塯	lntt
疁	lntu
蒥	lnuq
蓅	lnus
藰	lnut
琉	lnw
珋	lnwq
瑠	lnws
瑬	lnwt
璢	lnwu
窌	lnxq
懰	lnxs
翏	lnyq
鰡	lnys
遛	lnz
蹓	lnzq
蹘	lnzs
摞	loa
捰	loaq
擽	loas
攊	loat
攎	loau
攞	loav
攭	loaw
瘰	lob
皪	lobq
癳	lobs
螺	loc
寽	locq
蛒	locs
剆	lodq
洛	loe
漯	loec
泺	loep
濼	loeq
洜	loes
渃	loet
络	lof
絡	lofq
纙	lofs
烙	loh
椤	loi
欏	loiq
锣	loj
镙	lojp
鑼	lojq
鏍	lojs
覶	lojt
覼	loju
裸	lok
箩	lokp
籮	lokq
笿	loks
脶	lol
腡	lolq
臝	lols
骆	lom
骡	lomp
駱	lomq
騾	loms
犖	lonq
鵅	lons
鸁	lont
咯	loo
啰	looq
囉	loos
囖	loot
砢	lopq
硦	lops
磱	lopt
猡	loq
玀	loqq
曪	lorq
罗	los
羅	losq
峈	loss
躶	lost
饠	losu
蠃	lot
驘	lotq
落	lou
荦	louc
萝	loup
蘿	louq
蓏	lous
倮	lov
儸	lovq
珞	low
詻	loyq
頱	loys
鮥	loyt
逻	loz
雒	lozc
跞	lozp
躒	lozq
雡	lozs
擂	lpa
攂	lpaq
瘣	lpbq
癗	lpbs
蠝	lpcq
轠	lpcs
泪	lpe
淚	lpeq
洡	lpes
涙	lpet
灅	lpeu
累	lpf
缧	lpfp
縲	lpfq
絫	lpfs
罍	lpft
纍	lpfu
纇	lpfv
纝	lpfw
檑	lpi
樏	lpiq
櫑	lpis
櫐	lpit
欙	lpiu
镭	lpj
鐳	lpjq
銇	lpjs
錑	lpjt
鑘	lpju
鑸	lpjv
肋	lpl
耒	lplp
类	lpm
矋	lpmq
嫘	lpn
鸓	lpnq
嘞	lpo
磊	lpp
磥	lppq
礌	lpps
礧	lppt
礨	lppu
酹	lpq
雷	lpr
靁	lprq
厽	lpsq
祱	lpss
禷	lpst
鼺	lpsu
垒	lpt
羸	lptp
壘	lptq
塁	lpts
畾	lptt
壨	lptu
蕾	lpu
蔂	lpuq
蕌	lpus
藟	lput
蘲	lpuu
蘽	lpuv
蘱	lpuw
虆	lpux
儡	lpv
傫	lpvq
儽	lpvs
瓃	lpwq
诔	lpy
類	lpyq
誄	lpys
頛	lpyt
頪	lpyu
讄	lpyv
邏	lpzq
掚	lqaq
凉	lqb
辆	lqc
輛	lqcq
辌	lqcs
輌	lqct
蜽	lqcu
輬	lqcv
涼	lqeq
湸	lqes
緉	lqfq
良	lqg
魉	lqgp
魎	lqgq
两	lqh
両	lqhq
梁	lqi
椋	lqip
樑	lqiq
锒	lqj
鍄	lqjq
裲	lqkq
量	lql
脼	lqlq
粮	lqm
粱	lqmp
糧	lqmq
駺	lqms
唡	lqoq
哴	lqos
啢	lqot
喨	lqou
靓	lqq
靚	lqqq
晾	lqr
兩	lqrq
亮	lqt
墚	lqtp
莨	lqu
俩	lqv
倆	lqvq
俍	lqvs
倞	lqvt
悢	lqxq
谅	lqy
諒	lqyq
颣	lqys
挛	lra
攣	lraq
癴	lrbq
癵	lrbs
奱	lrdq
滦	lre
灤	lreq
灓	lres
栾	lri
欒	lriq
卵	lrj
銮	lrjp
鑾	lrjq
釠	lrjs
覶	lrjt
臠	lrlq
脟	lrls
臡	lrlt
娈	lrn
鸾	lrnp
孌	lrnq
鸞	lrns
鵉	lrnt
脔	lrr
曫	lrrq
峦	lrs
巒	lrsq
羉	lrss
薍	lruq
虊	lrus
乱	lrv
亂	lrvq
乿	lrvs
圝	lrwq
圞	lrws
孪	lrz
踉	lrzp
拢	lsa
攏	lsaq
癃	lsb
贚	lsbq
衖	lscq
徿	lscs
蠬	lsct
蠪	lscu
泷	lse
瀧	lseq
湰	lses
滝	lset
漋	lseu
隆	lsf
陇	lsfc
聋	lsfp
隴	lsfq
聾	lsfs
豅	lsgq
爖	lshq
栊	lsi
櫳	lsiq
梇	lsis
槞	lsit
鏧	lsjq
鑨	lsjs
笼	lsk
籠	lskq
篢	lsks
篭	lskt
襱	lsku
龙	lsl
胧	lslp
龍	lslq
朧	lsls
竜	lslt
龒	lslu
龓	lslv
眬	lsmq
矓	lsms
驡	lsmt
鸗	lsnq
咙	lso
嚨	lsoq
哢	lsos
砻	lsp
礱	lspq
硦	lsps
礲	lspt
昽	lsrq
霳	lsrs
曨	lsrt
靇	lsru
屸	lssq
嶐	lsss
巃	lsst
巄	lssu
垄	lst
垅	lstp
壟	lstq
壠	lsts
茏	lsu
蘢	lsuq
儱	lsvq
珑	lsw
瓏	lswq
窿	lsx
竉	lsxq
尨	lsyq
孿	lszq
捩	lta
挒	ltaq
挘	ltas
擸	ltat
冽	ltb
鬣	ltbp
鬛	ltbq
蛚	ltcq
巤	ltcs
列	ltd
洌	lte
浖	lteq
聗	ltfq
綟	ltfs
颲	ltft
烈	lth
烮	lthq
煭	lths
燤	ltht
爄	lthu
爉	lthv
栵	ltiq
棙	ltis
裂	ltk
劣	ltl
劦	ltlq
劽	ltls
脟	ltlt
姴	ltnq
鴷	ltns
犣	ltnt
咧	lto
哷	ltoq
猎	ltq
獵	ltqq
猟	ltqs
獦	ltqt
巁	ltsq
埒	ltt
埓	lttq
茢	ltuq
儠	ltvq
忚	ltxq
鮤	ltyq
鱲	ltys
趔	ltz
躐	ltzp
躘	ltzq
掳	lua
撸	luap
擄	luaq
擼	luas
摝	luat
攎	luau
卢	lub
赂	lubc
卤	lubp
賂	lubq
轳	luc
辘	lucc
辂	lucp
輅	lucq
轆	lucs
轤	luct
螰	lucu
蠦	lucv
剹	ludq
潞	lue
渌	luec
漉	lued
泸	luep
淥	lueq
瀘	lues
淕	luet
滷	lueu
澛	luev
瀂	luew
陆	luf
陸	lufq
緑	lufs
罏	luft
纑	lufu
庐	lug
戮	lugp
廬	lugq
廘	lugs
髗	lugt
炉	luh
虏	luhp
虜	luhq
爐	luhs
穭	luht
稑	luhu
熝	luhv
穋	luhw
穞	luhx
黸	luhy
栌	lui
橹	luip
櫓	luiq
櫨	luis
枦	luit
椂	luiu
樐	luiv
樚	luiw
镥	luj
鑪	lujn
觻	lujo
錄	lujq
鑥	lujs
鈩	lujt
錴	luju
録	lujv
鏀	lujw
鏕	lujx
鐪	lujy
鏴	lujz
簏	luk
箓	lukq
簶	luks
簵	lukt
簬	luku
籚	lukv
籙	lukw
鹿	lul
胪	lulc
麓	lulp
鹵	lulq
臚	luls
勎	lult
勠	lulu
膔	lulv
氇	lum
盧	lumq
氌	lums
睩	lumt
盝	lumu
馿	lumv
粶	lumw
騄	lumx
騼	lumy
矑	lumz
鸬	lun
鹭	lunp
鷺	lunq
鸕	luns
娽	lunt
鴼	lunu
鵱	lunv
鵦	lunw
噜	luo
嚕	luoq
嚧	luos
碌	lup
硉	lupq
硵	lups
磠	lupt
磟	lupu
醁	luqq
獹	luqs
露	lur
曥	lurq
禄	lus
祿	lusq
峍	luss
垆	lut
壚	lutq
圥	luts
坴	lutt
塷	lutu
塶	lutv
芦	luu
蘆	luuq
菉	luus
蓾	luut
蔍	luuu
蕗	luuv
虂	luuw
侓	luvq
僇	luvs
璐	luw
琭	luwq
璷	luws
瓐	luwt
录	lux
彔	luxq
玈	luxs
鲁	luy
鲈	luyc
颅	luyp
魯	luyq
顱	luys
鱸	luyt
甪	luyu
魲	luyv
謢	luyw
鯥	luyx
路	luz
逯	luzc
舻	luzp
艫	luzq
迾	luzs
舮	luzt
趢	luzu
踛	luzv
蹗	luzw
艪	luzx
捋	lva
捛	lvaq
挔	lvas
律	lvc
滤	lve
濾	lveq
绿	lvf
缕	lvfc
旅	lvfp
綠	lvfq
縷	lvfs
郘	lvft
絽	lvfu
緑	lvfv
繂	lvfw
虑	lvh
稆	lvhp
穭	lvhq
焒	lvhs
爈	lvht
榈	lvi
櫚	lviq
梠	lvis
櫖	lvit
铝	lvj
鋁	lvjq
鑢	lvjs
褛	lvk
褸	lvkq
箻	lvks
膂	lvl
膢	lvlq
膟	lvls
膐	lvlt
勴	lvlu
驴	lvm
闾	lvmp
驢	lvmq
閭	lvms
氀	lvmt
瞜	lvmu
鷜	lvnq
吕	lvo
呂	lvoq
哷	lvos
履	lvp
屡	lvpp
屢	lvpq
氯	lvq
祣	lvsq
嵂	lvss
卛	lvst
垏	lvtq
葎	lvuq
藘	lvus
侣	lvv
偻	lvvp
侶	lvvq
僂	lvvs
儢	lvvt
率	lvx
慮	lvxq
艣	lvzq
慺	lwxq
拎	lxa
撛	lxaq
凛	lxb
赁	lxbp
賃	lxbq
凜	lxbs
痳	lxbt
癝	lxbu
癛	lxbv
辚	lxc
臨	lxcq
轔	lxcs
轥	lxct
淋	lxe
潾	lxeq
澟	lxes
瀶	lxet
邻	lxf
鄰	lxfq
阾	lxfs
隣	lxft
綝	lxfu
繗	lxfv
廪	lxg
廩	lxgq
焛	lxhq
燐	lxhs
林	lxi
檩	lxip
檁	lxiq
橉	lxis
斴	lxjq
鏻	lxjs
箖	lxkq
临	lxl
麟	lxlp
麐	lxlq
粼	lxm
瞵	lxmp
冧	lxmq
粦	lxms
閵	lxmt
驎	lxmu
吝	lxo
啉	lxop
磷	lxp
碄	lxpq
獜	lxqq
霖	lxr
晽	lxrq
暽	lxrs
嶙	lxs
厸	lxsq
崊	lxss
疄	lxtq
壣	lxts
蔺	lxu
藺	lxuq
菻	lxus
倆	lxvq
亃	lxvs
僯	lxvt
琳	lxw
璘	lxwq
甐	lxws
懔	lxx
懍	lxxq
恡	lxxs
悋	lxxt
惏	lxxu
鳞	lxy
鱗	lxyq
翷	lxys
遴	lxz
躏	lxzp
躪	lxzq
躙	lxzs
掕	lyaq
凌	lyb
皊	lybq
龄	lyc
蛉	lycp
齡	lycq
彾	lycs
衑	lyct
軨	lycu
輘	lycv
齢	lycw
刢	lydq
泠	lye
淩	lyeq
澪	lyes
陵	lyf
绫	lyfc
酃	lyfd
聆	lyfp
綾	lyfq
紷	lyfs
灵	lyh
炩	lyhq
秢	lyhs
稜	lyht
燯	lyhu
爧	lyhv
柃	lyi
棂	lyip
欞	lyiq
櫺	lyis
铃	lyj
鈴	lyjq
錂	lyjs
袊	lykq
笭	lyks
裬	lykt
朎	lylq
竛	lyls
鹷	lylt
麢	lylu
龗	lylv
閝	lymq
駖	lyms
姈	lynq
鸰	lyns
婈	lynt
鴒	lynu
孁	lynv
另	lyo
呤	lyop
砱	lypq
狑	lyqq
醽	lyqs
零	lyr
靈	lyrq
昤	lyrs
霊	lyrt
霗	lyru
霝	lyrv
霛	lyrw
岭	lys
嶺	lysq
岺	lyss
崚	lyst
祾	lysu
坽	lytq
菱	lyu
苓	lyup
蓤	lyuq
蔆	lyus
蕶	lyut
蘦	lyuu
令	lyv
伶	lyvp
玲	lyw
瓴	lywc
囹	lywp
琌	lywq
领	lyy
翎	lyyc
鲮	lyyd
羚	lyyp
領	lyyq
鯪	lyys
羐	lyyt
詅	lyyu
魿	lyyv
夌	lyzq
舲	lyzs
跉	lyzt
蹸	lyzu
冷	lzb
稜	lzhq
楞	lzi
棱	lzip
睖	lzmq
唥	lzoq
碐	lzpq
塄	lzt
堎	lztq
薐	lzuq
倰	lzvq
愣	lzx
踜	lzzq
抹	maa
痲	mabq
痳	mabs
鬕	mabt
蚂	mac
蟆	macp
螞	macq
蟇	macs
溤	maeq
杩	mai
榪	maiq
鎷	majq
马	mam
骂	mamc
麽	mamd
麻	mamp
馬	mamq
閁	mams
睰	mamt
駡	mamu
妈	man
媽	manq
嫲	mans
犘	mant
鷌	manu
吗	mao
唛	maoc
嘛	maop
嗎	maoq
嘜	maos
码	map
碼	mapq
犸	maq
獁	maqq
罵	masq
祃	mass
禡	mast
菻	mauq
蔴	maus
亇	mavq
傌	mavs
玛	maw
瑪	mawq
鰢	mayq
孖	mazq
遤	mazs
贸	mcb
髦	mcbp
貿	mcbq
皃	mcbs
髳	mcbt
蝥	mcc
蟊	mccp
軞	mccq
蝐	mccs
泖	mce
渵	mceq
旄	mcf
鄚	mcfq
鄮	mcfs
緢	mcft
戼	mchq
秏	mchs
枆	mciq
柕	mcis
楙	mcit
帽	mcj
锚	mcjc
铆	mcjd
卯	mcjp
鉚	mcjq
錨	mcjs
覒	mcjt
鉾	mcju
袤	mck
笷	mckq
耄	mcl
毛	mcm
瞀	mcmc
矛	mcmp
毟	mcmq
眊	mcms
毷	mcmt
氂	mcmu
牦	mcn
媢	mcnq
犛	mcns
鶜	mcnt
猫	mcq
酕	mcqq
昴	mcr
暓	mcrq
峁	mcs
罞	mcsq
嵍	mcss
冒	mct
冇	mctq
冃	mcts
冐	mctt
堥	mctu
茂	mcu
茆	mcuc
茅	mcup
芼	mcuq
萺	mcus
蓩	mcut
乮	mcvq
瑁	mcw
瓱	mcwq
懋	mcx
夘	mcxq
愗	mcxs
貌	mcz
貓	mczq
買	mdbq
賣	mdbs
脉	mdl
劢	mdlp
脈	mdlq
勱	mdls
麦	mdm
麥	mdmq
鷶	mdnq
嘪	mdoq
霾	mdr
霡	mdrq
霢	mdrs
卖	mds
売	mdsq
埋	mdt
荬	mdu
蕒	mduq
薶	mdus
买	mdv
佅	mdvq
衇	mdxq
迈	mdz
邁	mdzq
濹	meeq
庅	megq
麽	mem
麼	memq
嚒	meoq
嚜	meos
嚰	meot
么	mep
蛑	mfc
缪	mff
繆	mffq
鞪	mfgq
某	mfi
桙	mfiq
鍪	mfj
劺	mflq
眸	mfm
麰	mfmq
牟	mfn
鴾	mfnq
哞	mfo
呣	mfoq
堥	mftq
侔	mfv
敄	mfwq
恈	mfxq
谋	mfy
謀	mfyq
踎	mfzq
扪	mga
捫	mgaq
焖	mgh
燜	mghq
穈	mghs
椚	mgiq
钔	mgj
鍆	mgjq
门	mgm
闷	mgmp
門	mgmq
瞞	mgms
閅	mgmt
暪	mgrq
亹	mgtq
菛	mguq
虋	mgus
们	mgv
們	mgvq
玧	mgwq
璊	mgws
斖	mgwt
懑	mgx
悶	mgxq
懣	mgxs
怋	mgxt
悗	mgxu
惛	mgxv
痝	mhbq
蟒	mhc
厖	mhcq
蛖	mhcs
蠎	mhct
漭	mhe
汒	mheq
浝	mhes
邙	mhf
庬	mhgq
杧	mhiq
杗	mhis
铓	mhjq
釯	mhjs
鋩	mhjt
笀	mhkq
朚	mhlq
盲	mhm
盳	mhmq
駹	mhms
牤	mhnq
娏	mhns
牻	mhnt
吂	mhoq
哤	mhos
硭	mhp
硥	mhpq
狵	mhqq
氓	mhs
壾	mhsq
茫	mhu
莽	mhuc
芒	mhup
莾	mhuq
茻	mhus
蘉	mhut
忙	mhx
恾	mhxq
尨	mhyq
摵	miaq
擟	mias
攠	miat
宓	mib
宻	mibq
镾	mibs
蜜	mic
鼏	midq
泌	mie
灖	mien
瀰	mieo
汨	miep
沕	mieq
沵	mies
洣	miet
淧	mieu
渳	miev
漞	miew
滵	miex
濗	miey
濔	miez
靡	mif
縻	mifc
糸	mifp
弥	mig
弭	migp
彌	migq
秘	mih
熐	mihq
爢	mihs
枈	miiq
榓	miis
樒	miit
檷	miiu
櫁	miiv
觅	mij
覓	mijq
覔	mijs
幎	mijt
覛	miju
銤	mijv
幦	mijw
袮	mikq
簚	miks
脒	mil
麋	milp
麊	milq
麛	mils
米	mim
糜	mimc
幂	mimd
冖	mime
敉	mimf
眯	mimp
瞇	mimq
冪	mims
粎	mimt
瞴	mimu
麿	mimv
孊	minq
鸍	mins
咪	mio
嘧	miop
醚	miq
猕	miqp
獼	miqq
醾	miqs
醿	miqt
釄	miqu
密	mis
祢	misp
禰	misq
峚	miss
祕	mist
羃	misu
塓	mitq
芈	miu
蒾	miuq
葞	mius
蓂	miut
蔝	miuu
蔤	miuv
藌	miuw
蘪	miux
侎	mivq
瓕	miwq
怽	mixq
戂	mixs
谜	miy
谧	miyp
謎	miyq
羋	miys
謐	miyt
詸	miyu
迷	miz
宀	mjb
蝒	mjcq
免	mjd
沔	mje
湎	mjec
渑	mjep
澠	mjeq
汅	mjes
绵	mjf
缅	mjfp
綿	mjfq
緬	mjfs
絻	mjft
緜	mjfu
丏	mjhq
棉	mji
杣	mjiq
檰	mjis
櫋	mjit
勉	mjl
腼	mjlp
勔	mjlq
面	mjm
眄	mjmc
矏	mjmm
麵	mjmn
矊	mjmo
眠	mjmp
黽	mjmq
靦	mjms
靣	mjmt
睌	mjmu
麫	mjmv
麪	mjmw
糆	mjmx
麺	mjmy
矈	mjmz
娩	mjn
婂	mjnq
媔	mjns
嬵	mjnt
喕	mjoq
牑	mjpq
冕	mjt
芇	mjuq
莬	mjus
葂	mjut
俛	mjvq
偭	mjvs
愐	mjxq
鮸	mjyq
臱	mjzq
摱	mlaq
鬗	mlbq
鬘	mlbs
蛮	mlc
螨	mlcp
蠻	mlcq
蟎	mlcs
满	mle
漫	mlep
滿	mleq
満	mles
澫	mlet
澷	mleu
缦	mlf
縵	mlfq
鄤	mlfs
絻	mlft
鞔	mlg
匁	mlgq
熳	mlh
樠	mliq
槾	mlis
幔	mlj
镘	mljp
鏝	mljq
鏋	mljs
襔	mlkq
瞒	mlm
瞞	mlmq
矕	mlms
娨	mlnq
嫚	mlns
屘	mlpq
獌	mlqq
曼	mlr
馒	mls
饅	mlsq
墁	mlt
蔓	mlu
蔄	mluq
蘰	mlus
僈	mlvq
慢	mlx
悗	mlxq
慲	mlxs
谩	mly
鳗	mlyc
颟	mlyp
謾	mlyq
顢	mlys
鰻	mlyt
描	mma
渺	mme
淼	mmep
缈	mmf
缪	mmfp
緲	mmfq
繆	mmfs
緢	mmft
庙	mmg
廟	mmgq
庿	mmgs
秒	mmh
杪	mmi
篎	mmkq
劰	mmlq
竗	mmls
瞄	mmm
眇	mmmp
妙	mmn
鹋	mmnp
鶓	mmnq
媌	mmns
嫹	mmnt
喵	mmo
厸	mmsq
苗	mmu
藐	mmup
仯	mmvq
玅	mmxq
邈	mmz
缪	mnf
繆	mnfq
谬	mny
謬	mnyq
摸	moa
抹	moac
摹	moad
摩	moap
擵	moaq
攠	moas
寞	mob
瘼	mobp
皌	mobq
癦	mobs
蛨	mocq
蟔	mocs
殁	mod
歿	modq
歾	mods
劘	modt
没	moe
沫	moec
漠	moep
沒	moeq
瀎	moes
陌	mof
絈	mofq
絔	mofs
縸	moft
纆	mofu
魔	mog
庅	mogq
靺	mogs
骳	mogt
髍	mogu
默	moh
秣	mohp
無	mohq
黙	mohs
爅	moht
模	moi
末	moip
枺	moiq
橅	mois
镆	moj
鏌	mojq
帓	mojs
帞	mojt
銆	moju
袹	mokq
脉	mol
耱	molc
膜	molp
蓦	mom
麽	momp
麼	momq
驀	moms
眜	momt
眿	momu
眽	momv
瞙	momw
瞐	momx
糢	momy
嫫	mon
嬷	monp
嬤	monq
妺	mons
嫼	mont
呒	moo
唜	mooq
嗼	moos
嚜	moot
嚤	moou
磨	mop
砞	mopq
礳	mops
狢	moqq
獏	moqs
昩	morq
馍	mos
饃	mosq
饝	moss
墨	mot
圽	motq
冐	mots
塻	mott
莫	mou
茉	mouc
蘑	moup
萬	mouq
莈	mous
藦	mout
尛	moxq
衇	moxs
懡	moxt
戂	moxu
谟	moy
謨	moyq
魹	moys
魩	moyt
謩	moyu
貊	moz
貘	mozp
貃	mozq
貈	mozs
抺	mpaq
挴	mpas
攗	mpat
寐	mpb
凂	mpbq
痗	mpbs
蝞	mpcq
徾	mpcs
殙	mpdq
没	mpe
湄	mpec
浼	mpep
沒	mpeq
沬	mpes
湈	mpet
渼	mpeu
郿	mpfq
魅	mpg
鬽	mpgq
煤	mph
黴	mphq
煝	mphs
穈	mpht
燘	mphu
黣	mphv
梅	mpi
楣	mpic
枚	mpip
栂	mpiq
楳	mpis
槑	mpit
櫗	mpiu
镁	mpj
镅	mpjp
鎂	mpjq
鎇	mpjs
鋂	mpjt
袂	mpk
篃	mpkq
脄	mplq
脢	mpls
腜	mplt
每	mpm
糜	mpmc
眉	mpmp
毎	mpmq
眛	mpms
睂	mpmt
睸	mpmu
妹	mpn
媒	mpnc
鹛	mpnd
媚	mpnp
鶥	mpnq
媄	mpns
媺	mpnt
嬍	mpnu
嚜	mpoq
酶	mpq
猸	mpqp
霉	mpr
昧	mprp
嵋	mps
祙	mpsq
嵄	mpss
禖	mpst
躾	mpsu
坆	mptq
堳	mpts
塺	mptt
莓	mpu
苺	mpuq
葿	mpus
蘪	mput
玫	mpw
珻	mpwq
瑂	mpws
韎	mpwt
美	mpy
謎	mpyq
羙	mpys
跊	mpzq
搣	mtaq
蠛	mtc
滅	mteq
瀎	mtes
旀	mtfq
灭	mth
烕	mthq
櫗	mtiq
覕	mtjq
幭	mtjs
鑖	mtjt
篾	mtk
簚	mtkq
眜	mtmq
鴓	mtnq
咩	mto
吀	mtoq
哶	mtos
礣	mtpq
蔑	mtu
薎	mtuq
乜	mtv
懱	mtxq
衊	mtxs
鱴	mtyq
孭	mtzq
拇	mua
蚞	mucq
沐	mue
繆	mufq
縸	mufs
鞪	mugq
穆	muh
炑	muhq
木	mui
朰	muiq
朷	muis
楘	muit
樢	muiu
幕	muj
钼	mujp
鉬	mujq
凩	mujs
幙	mujt
鉧	muju
募	mul
胟	mulq
母	mum
睦	mumc
毪	mumd
目	mump
毣	mumq
氁	mums
牧	mun
牡	munc
牟	mund
姆	munp
牳	munq
娒	muns
嘸	muoq
呣	muos
砪	mupq
狇	muqq
暮	mur
雮	murq
暯	murs
霂	murt
峔	musq
亩	mut
坶	mutc
墓	mutp
畝	mutq
畂	muts
畒	mutt
畆	mutu
畞	mutv
畮	mutw
苜	muu
莯	muuq
仫	muv
慕	mux
慔	muxq
踇	muzq
艒	muzs
抿	mxa
捪	mxaq
冺	mxbq
痻	mxbs
賯	mxbt
蠠	mxcq
刡	mxdq
泯	mxe
湣	mxeq
渂	mxes
湏	mxet
潣	mxeu
缗	mxf
緡	mxfq
緍	mxfs
鈱	mxjq
錉	mxjs
鍲	mxjt
笽	mxkq
笢	mxks
簢	mxkt
勄	mxlq
闽	mxm
闵	mxmc
黾	mxmd
皿	mxmp
閩	mxmq
閔	mxms
黽	mxmt
盿	mxmu
姄	mxnq
鴖	mxns
呡	mxoq
砇	mxpq
碈	mxps
旻	mxrq
旼	mxrs
暋	mxrt
民	mxs
岷	mxsp
罠	mxsq
崏	mxss
垊	mxtq
苠	mxu
僶	mxvq
敏	mxw
珉	mxwc
玟	mxwp
瑉	mxwq
敃	mxws
琝	mxwt
琘	mxwu
敯	mxwv
悯	mxx
愍	mxxp
憫	mxxq
忟	mxxs
忞	mxxt
怋	mxxu
惽	mxxv
慜	mxxw
鳘	mxy
鰵	mxyq
掵	myaq
凕	mybq
螟	myc
溟	mye
洺	myeq
鄍	myfq
椧	myiq
榠	myis
铭	myj
銘	myjq
覭	myjs
朙	mylq
冥	mym
瞑	mymp
眀	mymq
眳	myms
鸣	myn
鳴	mynq
姳	myns
嫇	mynt
名	myo
酩	myq
猽	myqq
明	myr
暝	myrp
茗	myu
蓂	myuq
命	myv
佲	myvq
慏	myxq
詺	myyq
掹	mzaq
擝	mzas
髳	mzbq
虻	mzc
蠓	mzcc
蜢	mzcp
蝱	mzcq
溕	mzeq
濛	mzes
鄸	mzfq
鄳	mzfs
庬	mzgq
梦	mzi
檬	mzip
橗	mziq
锰	mzj
錳	mzjq
鋂	mzjs
幪	mzjt
勐	mzl
朦	mzlp
盟	mzm
瞢	mzmp
黽	mzmq
冡	mzms
氋	mzmt
矇	mzmu
矒	mzmv
鼆	mzmw
鹲	mznq
鸏	mzns
礞	mzp
猛	mzq
獴	mzqq
雺	mzrq
曚	mzrs
霥	mzrt
靀	mzru
霿	mzrv
饛	mzsq
甿	mztq
蒙	mzu
萌	mzup
莔	mzuq
蕄	mzus
儚	mzvq
甍	mzw
懵	mzx
夢	mzxq
夣	mzxs
懜	mzxt
懞	mzxu
尨	mzyq
鯍	mzys
鯭	mzyt
顭	mzyu
孟	mzz
艨	mzzc
艋	mzzp
拿	naa
捺	naap
抐	naaq
拏	naas
挐	naat
搻	naau
軜	nacq
乀	nadq
那	naf
纳	nafp
納	nafq
郍	nafs
靹	nagq
秅	nahq
钠	naj
镎	najp
鈉	najq
鎿	najs
衲	nak
袦	nakq
笚	naks
笝	nakt
肭	nal
娜	nan
妠	nanq
哪	nao
呐	naop
吶	naoq
嗱	naos
雫	narq
蒘	nauq
蒳	naus
乸	navq
讷	nay
魶	nayq
誽	nays
豽	nazq
貀	nazs
挠	nca
撓	ncaq
摎	ncas
匘	ncbq
蛲	ncc
蟯	nccq
鬧	ncdq
淖	nce
橈	nciq
铙	ncj
鐃	ncjq
脑	ncl
腦	nclq
脳	ncls
臑	nclt
闹	ncm
閙	ncmq
婥	ncnq
嫐	ncns
呶	nco
硇	ncp
碙	ncpq
碯	ncps
猱	ncq
獶	ncqq
獿	ncqs
峱	ncsq
嶩	ncss
巎	ncst
垴	nct
堖	nctq
瑙	ncw
恼	ncx
惱	ncxq
怓	ncxs
悩	ncxt
憹	ncxu
詉	ncyq
譊	ncys
孬	ncz
夒	nczq
搱	ndaq
摨	ndas
疓	ndbq
螚	ndcq
奈	ndd
鼐	nddp
耐	nde
耏	ndeq
渿	ndes
柰	ndi
釢	ndjq
銰	ndjs
錼	ndjt
褦	ndkq
腉	ndlq
奶	ndn
妳	ndnq
嬭	ndns
乃	ndp
氖	ndq
艿	ndu
萘	ndup
莻	nduq
佴	ndv
倷	ndvq
廼	ndyq
迺	ndzq
孻	ndzs
抐	neaq
疒	neb
眲	nemq
呢	neo
哪	neop
吶	neoq
讷	ney
訥	neyq
搙	nfaq
槈	nfiq
檽	nfis
鎒	nfjq
鐞	nfjs
耨	nfl
獳	nfqq
羺	nfyq
疟	ngb
瘧	ngbq
虐	ngh
嫩	ngn
婩	ngnq
媆	ngns
硸	ngpq
恁	ngx
攮	nha
搑	nhaq
擃	nhas
齉	nhbq
蠰	nhcq
涳	nheq
瀼	nhes
灢	nhet
欜	nhiq
囊	nho
囔	nhop
嚢	nhoq
曩	nhr
馕	nhs
饢	nhsq
乪	nhvq
儾	nhvs
憹	nhxq
拟	nia
擬	niaq
抐	nias
抳	niat
掜	niau
屰	nibq
蚭	nicq
蛪	nics
蜺	nict
輗	nicu
齯	nicv
泥	nie
溺	niep
兒	nieq
氼	nies
淣	niet
濔	nieu
匿	nif
旎	nifp
郳	nifq
聣	nifs
縌	nift
隬	nifu
聻	nifv
秜	nihq
柅	niiq
棿	niis
檷	niit
铌	nij
鈮	nijq
觬	nijs
腻	nil
膩	nilq
胒	nils
麑	nilt
臡	nilu
睨	nim
籾	nimq
眤	nims
妮	nin
妳	ninq
婗	nins
嫟	nint
嬺	ninu
尼	nip
屔	nipq
猊	niq
狔	niqq
霓	nir
昵	nirp
晲	nirq
暱	nirs
坭	nit
堄	nitq
埿	nits
蘼	niu
苨	niuq
薿	nius
你	niv
伲	nivc
倪	nivp
伱	nivq
儞	nivs
儗	nivt
怩	nix
惄	nixq
愵	nixs
馜	nixt
懝	nixu
鲵	niy
鯢	niyq
誽	niys
逆	niz
跜	nizq
孴	nizs
貎	nizt
捻	nja
撵	njac
拈	njap
撚	njaq
攆	njas
辇	njc
輾	njcq
輦	njcs
涊	njeq
淰	njes
溓	njet
廿	njh
黏	njhp
秊	njhq
秊	njhs
秥	njht
焾	njhu
榐	njiq
簐	njkq
粘	njm
姩	njnq
鵇	njns
哖	njoq
唸	njos
年	njp
碾	njpp
卄	njsq
埝	njt
蔫	nju
念	njx
悥	njxq
惗	njxs
鲇	njy
鲶	njyp
鮎	njyq
鯰	njys
艌	njzq
蹍	njzs
蹨	njzt
躎	njzu
黁	nkmq
嫰	nkn
抩	nlaq
揇	nlas
赧	nlc
蝻	nlcp
湳	nleq
煵	nlhq
楠	nli
枏	nliq
柟	nlis
腩	nll
妠	nlnq
娚	nlns
婻	nlnt
嫨	nlnu
喃	nlo
暔	nlrq
南	nls
男	nlt
畘	nltq
莮	nluq
萳	nlus
侽	nlvq
囝	nlw
囡	nlwp
戁	nlxq
諵	nlyq
难	nlz
難	nlzq
遖	nlzs
樢	nmiq
袅	nmk
裊	nmkq
褭	nmks
脲	nml
鸟	nmn
嬲	nmnp
鳥	nmnq
嫋	nmns
嬝	nmnt
尿	nmp
茑	nmu
蔦	nmuq
扭	nna
拗	nnap
抝	nnaq
汼	nneq
沑	nnes
纽	nnf
紐	nnfq
靵	nngq
炄	nnhq
杻	nniq
钮	nnj
鈕	nnjq
牛	nnn
妞	nnnp
牜	nnnq
狃	nnq
莥	nnuq
忸	nnx
怓	nnxq
挪	noa
搦	noap
挼	noaq
掿	noas
搙	noat
搻	noau
耎	noeq
稬	nohq
穤	nohs
梛	noiq
榒	nois
橠	noit
锘	noj
鍩	nojq
袳	nokq
袲	noks
糯	nom
毭	nomq
糑	noms
糥	nomt
娜	non
喏	noo
傩	nov
儺	novq
懦	nox
愞	noxq
懧	noxs
诺	noy
諾	noyq
詝	noys
難	nozq
逽	nozs
蹃	nozt
浽	npeq
錗	npjq
脮	nplq
腇	npls
娞	npnq
氝	npqq
氞	npqs
內	nprq
馁	nps
餒	npsq
餧	npss
内	npt
鮾	npyq
鯘	npys
娘	nqn
嬢	nqnq
孃	nqns
酿	nqq
釀	nqqq
醸	nqqs
渜	nreq
湪	nres
煗	nrhq
煖	nrhs
奻	nrnq
暖	nrr
餪	nrsq
挊	nsaq
挵	nsas
癑	nsbq
鬞	nsbs
齈	nsbt
農	nscq
辳	nscs
浓	nse
濃	nseq
繷	nsfq
弄	nsg
秾	nshq
燶	nshs
穠	nsht
檂	nsiq
欁	nsis
襛	nskq
脓	nsl
膿	nslq
农	nsm
哝	nso
噥	nsoq
醲	nsqq
禯	nssq
蕽	nsuq
侬	nsv
儂	nsvq
譨	nsyq
捏	nta
攝	ntaq
掜	ntas
揑	ntat
摰	ntau
痆	ntbq
齧	ntcq
蠥	ntcs
涅	nte
湼	nteq
聂	ntf
陧	ntfp
聶	ntfq
隉	ntfs
枿	ntiq
槷	ntis
櫱	ntit
镊	ntj
镍	ntjp
鎳	ntjq
鑷	ntjs
帇	ntjt
銸	ntju
鋷	ntjv
錜	ntjw
鑈	ntjx
钀	ntjy
篞	ntkq
籋	ntks
闑	ntmq
糵	ntms
糱	ntmt
啮	nto
嗫	ntop
嚙	ntoq
囁	ntos
噛	ntot
囐	ntou
囓	ntov
峊	ntsq
嵲	ntss
嶭	ntst
巕	ntsu
圼	nttq
蘖	ntu
苶	ntuq
菍	ntus
乜	ntv
敜	ntwq
颞	nty
顳	ntyq
讘	ntys
孽	ntz
蹑	ntzc
臬	ntzp
躡	ntzq
踂	ntzs
踙	ntzt
踗	ntzu
臲	ntzv
孼	ntzw
搙	nuaq
弩	nug
笯	nukq
努	nul
驽	num
駑	numq
奴	nun
砮	nupq
胬	nur
伮	nuvq
傉	nuvs
怒	nux
孥	nuz
沑	nveq
聏	nvfq
钕	nvj
釹	nvjq
朒	nvlq
籹	nvmq
女	nvn
恧	nvx
衄	nvxp
衂	nvxq
拰	nxaq
脌	nxlq
囜	nxwq
您	nxx
拧	nya
擰	nyaq
宁	nyb
凝	nybp
寧	nybq
寕	nybs
寍	nybt
寗	nybu
寜	nybv
鬡	nybw
泞	nye
濘	nyeq
澝	nyes
聍	nyf
聹	nyfq
柠	nyi
檸	nyiq
橣	nyis
鑏	nyjq
矃	nymq
嬣	nynq
鸋	nyns
咛	nyo
嚀	nyoq
狞	nyq
獰	nyqq
苧	nyuq
薴	nyus
佞	nyv
侫	nyvq
倿	nyvs
儜	nyvt
甯	nyy
螚	nzcq
能	nzl
筽	ookq
哦	ooo
噢	ooop
嚄	oooq
沤	oue
漚	oueq
區	oufq
髃	ougq
熰	ouhq
櫙	ouiq
鏂	oujq
耦	oul
腢	oulq
膒	ouls
鸥	oun
鷗	ounq
鴎	ouns
呕	ouo
嘔	ouoq
吘	ouos
吽	ouot
殴	oup
毆	oupq
欧	ouq
歐	ouqq
塸	outq
藕	ouu
蕅	ouuq
藲	ouus
偶	ouv
瓯	ouw
甌	ouwq
怄	oux
慪	ouxq
讴	ouy
謳	ouyq
扒	paa
掱	paaq
皅	pabq
汃	paeq
潖	paes
杷	pai
帕	paj
鈀	pajq
帊	pajs
筢	pak
袙	pakq
耙	pal
妑	panq
啪	pao
葩	pau
苩	pauq
琶	paw
怕	pax
爬	paz
趴	pazp
舥	pazq
抛	pca
拋	pcaq
疱	pcb
軳	pccq
刨	pcd
匏	pcdp
奅	pcdq
泡	pce
庖	pcg
瓟	pcgq
鞄	pcgs
炮	pch
炰	pchq
烰	pchs
穮	pcht
鉋	pcjq
鑤	pcjs
袍	pck
袌	pckq
褜	pcks
脬	pcl
麅	pclq
麃	pcls
靤	pcmq
麭	pcms
咆	pco
嚗	pcoq
皰	pcpq
砲	pcps
礟	pcpt
礮	pcpu
狍	pcq
垉	pctq
萢	pcuq
藨	pcus
跑	pcz
爮	pczq
跁	pczs
排	pda
拍	pdap
徘	pdc
輫	pdcq
派	pde
湃	pdep
沠	pdeq
渒	pdes
棑	pdiq
鎃	pdjq
箄	pdkq
簰	pdks
簲	pdkt
闏	pdmq
哌	pdo
牌	pdp
猅	pdqq
蒎	pdu
俳	pdv
廹	pdyq
掊	pfa
抔	pfaq
抙	pfas
捊	pfat
剖	pfd
棓	pfiq
裒	pfk
箁	pfkq
娝	pfnq
婄	pfns
犃	pfnt
咅	pfoq
哣	pfos
垺	pftq
湓	pge
濆	pgeq
盆	pgm
喷	pgo
噴	pgoq
呠	pgos
喯	pgot
歕	pgqq
葐	pguq
瓫	pgwq
翸	pgyq
髣	phbq
彷	phc
螃	phcp
厐	phcq
徬	phcs
滂	phe
汸	pheq
沗	phes
旁	phf
庞	phg
庬	phgq
髈	phgs
炐	phhq
覫	phjq
篣	phkq
胖	phl
耪	phlp
龐	phlq
肨	phls
胮	phlt
膖	phlu
龎	phlv
眫	phmq
嫎	phnq
嗙	phoq
磅	php
乓	phpp
雱	phrq
霶	phrs
攵	phw
尨	phyq
鳑	phys
鰟	phyt
夂	phz
逄	phzp
夆	phzq
趽	phzs
舽	phzt
批	pia
擗	piac
披	piap
抷	piaq
揊	pias
疲	pib
癖	pibc
痞	pibp
毘	pibq
髬	pibs
蚍	pic
蜱	picp
蚽	picq
蚾	pics
螕	pict
螷	picu
蠯	picv
劈	pid
淠	pie
潎	pieq
澼	pies
匹	pif
纰	pifc
郫	pifd
陴	pife
邳	pifp
紕	pifq
阰	pifs
旇	pift
隦	pifu
庀	pig
鼙	pigp
鞞	pigq
丕	pih
炋	pihq
秠	pihs
秛	piht
焷	pihu
稫	pihv
枇	pii
枈	piiq
椑	piis
榌	piit
铍	pij
鈹	pijq
鈚	pijs
釽	pijt
鉟	piju
銢	pijv
銔	pijw
錍	pijx
錃	pijy
鎞	pijz
被	pik
笓	pikq
篺	piks
脾	pil
肶	pilq
耚	pils
脴	pilt
腗	pilu
膍	pilv
駓	pimq
闢	pims
媲	pin
妚	pinq
嫓	pins
鴄	pint
鵧	pinu
鷿	pinv
鸊	pinw
否	pio
噼	pioc
啤	piop
噽	pioq
嚊	pios
嚭	piot
皮	pip
砒	pipc
屁	pipp
磇	pipq
礔	pips
礕	pipt
狉	piqq
狓	piqs
猈	piqt
霹	pir
朇	pirq
罴	pis
罷	pisq
羆	piss
岯	pist
崥	pisu
禆	pisv
嶏	pisw
坯	pit
圮	pitc
埤	pitd
毗	pitp
壀	pitq
疈	pits
芘	piu
苉	piuq
僻	piv
仳	pivp
伓	pivq
伾	pivs
琵	piw
甓	piwp
辟	pix
怶	pixq
悂	pixs
憵	pixt
譬	piy
翍	piyq
鲏	piys
魮	piyt
諀	piyu
魾	piyv
鮍	piyw
疋	piz
貔	pizp
豼	pizq
豾	pizs
貵	pjbq
賆	pjbs
緶	pjfq
骿	pjgq
楩	pjiq
楄	pjis
覑	pjjq
篇	pjk
胼	pjl
腁	pjlq
骗	pjm
骈	pjmp
騙	pjmq
駢	pjms
騈	pjmt
騗	pjmu
犏	pjn
媥	pjnq
鶣	pjns
片	pjp
猵	pjqq
獱	pjqs
便	pjv
偏	pjvp
囨	pjwq
瑸	pjws
璸	pjwt
谝	pjy
翩	pjyp
諞	pjyq
魸	pjys
蹁	pjz
跰	pjzq
攀	pla
拚	plap
搫	plaq
冸	plbq
蟠	plc
判	pld
潘	ple
泮	plep
沜	pleq
洀	ples
湴	plet
溿	pleu
瀊	plev
縏	plfq
鞶	plgq
炍	plhq
柈	pliq
槃	plis
幋	pljq
鋬	pljs
鎜	pljt
鑻	plju
袢	plk
襻	plkp
籓	plkq
胖	pll
肨	pllq
膰	plls
盘	plm
盼	plmp
盤	plmq
眅	plms
盻	plmt
眫	plmu
闆	plmv
媻	plnq
鵥	plns
磐	plp
爿	plpc
丬	plpp
牉	plpq
磻	plps
畔	plt
坢	pltq
畨	plts
萠	pluq
蒰	plus
叛	ply
詊	plyq
頖	plys
蹒	plz
蹣	plzq
跘	plzs
皫	pmbq
螵	pmc
徱	pmcq
殍	pmd
剽	pmdp
漂	pme
飘	pmf
缥	pmfp
飄	pmfq
縹	pmfs
旚	pmft
飃	pmfu
瓢	pmg
魒	pmgq
篻	pmkq
勡	pmlq
瞟	pmm
驃	pmmq
闝	pmms
嫖	pmn
犥	pmnq
嘌	pmo
醥	pmqq
票	pms
彯	pmsq
莩	pmu
薸	pmuq
僄	pmvq
慓	pmxq
鰾	pmyq
翲	pmys
顠	pmyt
掊	poa
搫	poaq
魄	pob
皤	pobp
髲	pobq
尀	pocq
奤	podq
泼	poe
潑	poeq
濼	poes
洦	poet
湐	poeu
溌	poev
叵	pof
鄱	pofp
烞	pohq
桲	poiq
櫇	pois
钋	poj
钷	pojp
釙	pojq
鉕	pojs
鏺	pojt
笸	pok
箥	pokq
粕	pom
駊	pomq
婆	pon
哱	pooq
嘙	poos
嚩	poot
破	pop
颇	popp
砶	popq
酦	poqq
猼	poqs
醗	poqt
醱	poqu
昢	porq
岶	posq
岥	poss
坡	pot
蒪	pouq
蔢	pous
珀	pow
敀	powq
覇	poxq
頗	poyq
廹	poys
翍	poyt
迫	poz
抷	ppaq
攈	ppas
赔	ppb
賠	ppbq
轡	ppcq
沛	ppe
浿	ppeq
陪	ppf
旆	ppfp
阫	ppfq
斾	ppfs
柸	ppiq
柭	ppis
棑	ppit
帔	ppj
锫	ppjp
錇	ppjq
裴	ppk
裶	ppkq
裵	ppks
胚	ppl
肧	pplq
毰	ppmq
馷	ppms
妚	ppnq
姵	ppns
婄	ppnt
媐	ppnu
呸	ppo
辔	ppop
配	ppq
醅	ppqp
犻	ppqq
霈	ppr
嶏	ppsq
培	ppt
蓜	ppuq
佩	ppv
伂	ppvq
俖	ppvs
珮	ppwq
琣	ppws
怌	ppxq
衃	ppxs
撇	pta
撆	ptaq
潎	pteq
覕	ptjq
鐅	ptjs
瞥	ptm
嫳	ptnq
丿	ptp
氕	ptq
暼	ptrq
彡	pts
苤	ptu
扑	pua
撲	puaq
抪	puas
捗	puat
擈	puau
匍	pub
痡	pubq
贌	pubs
瀑	pue
溥	puec
濮	pued
浦	puep
潽	pueq
陠	pufq
纀	pufs
巬	pugq
炇	puhq
烳	puhs
秿	puht
穙	puhu
朴	pui
樸	puiq
柨	puis
檏	puit
铺	puj
镨	pujc
镤	pujp
鋪	pujq
鏷	pujs
鐠	pujt
箁	pukq
氆	pum
毬	pumq
瞨	pums
噗	puo
酺	puqq
獛	puqs
普	pur
曝	purc
暴	purp
暜	purq
埔	put
圤	putq
墣	puts
菩	puu
蒲	puuc
莆	puud
葡	puup
菐	puuq
蒱	puus
仆	puv
僕	puvq
舖	puvs
舗	puvt
圃	puw
璞	puwc
攴	puwp
圑	puwq
谱	puy
譜	puyq
諩	puys
鯆	puyt
蹼	puz
拼	pxa
贫	pxb
貧	pxbq
蠙	pxcq
汖	pxeq
聘	pxf
穦	pxhq
榀	pxi
朩	pxiq
矉	pxmq
驞	pxms
牝	pxn
嫔	pxnc
姘	pxnp
嬪	pxnq
娦	pxns
品	pxo
嚬	pxoq
砏	pxpq
礗	pxps
蘋	pxuq
薲	pxus
玭	pxwq
琕	pxws
馪	pxxq
频	pxy
颦	pxyp
頻	pxyq
顰	pxys
冯	pyb
蚲	pycq
蛢	pycs
軿	pyct
泙	pyeq
洴	pyes
涄	pyet
淜	pyeu
郱	pyfq
聠	pyfs
缾	pyft
庰	pygq
平	pyh
焩	pyhq
枰	pyi
檘	pyiq
凭	pyj
帡	pyjq
帲	pyjs
幈	pyjt
凴	pyju
箳	pykq
簈	pyks
胓	pylq
竮	pyls
馮	pymq
娉	pyn
呯	pyoq
屏	pyp
乒	pypp
砯	pypq
硑	pyps
屛	pypt
岼	pysq
艵	pyss
坪	pyt
甹	pytq
塀	pyts
苹	pyu
萍	pyup
蘋	pyuq
荓	pyus
蓱	pyut
俜	pyv
瓶	pyw
玶	pywq
甁	pyws
憑	pyxq
慿	pyxs
评	pyy
鲆	pyyp
評	pyyq
鮃	pyys
頩	pyyt
捧	pza
抨	pzap
挷	pzaq
捀	pzas
掽	pzat
摓	pzau
搒	pzav
匉	pzbq
皏	pzbs
痭	pzbt
髼	pzbu
鬅	pzbv
鬔	pzbw
蟛	pzc
軯	pzcq
輧	pzcs
輣	pzct
蟚	pzcu
剻	pzdq
澎	pze
泙	pzeq
淎	pzes
淜	pzet
漨	pzeu
漰	pzev
絣	pzfq
纄	pzfs
弸	pzgq
烹	pzh
稝	pzhq
熢	pzhs
棚	pzi
梈	pziq
椪	pzis
椖	pzit
樥	pziu
槰	pziv
錋	pzjq
鑝	pzjs
篷	pzk
竼	pzkq
袶	pzks
篣	pzkt
朋	pzl
膨	pzlp
胓	pzlq
閛	pzmq
駍	pzms
騯	pzmt
鹏	pzn
鵬	pznq
嘭	pzo
碰	pzp
硼	pzpc
砰	pzpp
硑	pzpq
磞	pzps
彭	pzs
堋	pzt
塳	pztq
塜	pzts
蓬	pzu
芃	pzuq
莑	pzus
蘕	pzut
伻	pzvq
倗	pzvs
傰	pzvt
怦	pzx
恲	pzxq
憉	pzxs
韸	pzyq
韼	pzys
踫	pzzq
搉	qgaq
瘸	qgb
蚗	qgcq
汋	qgeq
缺	qgf
缼	qgfq
炔	qgh
燩	qghq
榷	qgi
棤	qgiq
却	qgj
卻	qgjq
阕	qgm
阙	qgmp
闋	qgmq
闕	qgms
鹊	qgn
鵲	qgnq
确	qgp
確	qgpq
硞	qgps
皵	qgpt
碏	qgpu
碻	qgpv
礐	qgpw
礭	qgpx
崅	qgsq
埆	qgtq
塙	qgts
墧	qgtt
蒛	qguq
傕	qgvq
琷	qgwq
敠	qgws
敪	qgwt
悫	qgx
愨	qgxq
慤	qgxs
雀	qgz
趞	qgzq
扱	qiaq
掑	qias
捿	qiat
摖	qiau
其	qib
凄	qibp
疧	qibq
鬐	qibs
蛴	qic
蜞	qicp
蠐	qicq
蚑	qics
蚚	qict
蚔	qicu
軝	qicv
蜝	qicw
螧	qicx
螇	qicy
蟿	qicz
奇	qid
契	qidp
豈	qidq
剘	qids
汽	qie
泣	qiec
沏	qied
汔	qiee
淇	qief
漆	qiep
淒	qieq
亝	qies
洓	qiet
湆	qieu
湇	qiev
滊	qiew
濝	qiex
旗	qif
绮	qifc
綦	qifd
罊	qifl
鄿	qifm
綥	qifn
緀	qifo
缉	qifp
緝	qifq
綺	qifs
邔	qift
郪	qifu
旂	qifv
陭	qifw
隑	qifx
紪	qify
綨	qifz
弃	qig
戚	qigp
鬿	qigq
魌	qigs
七	qih
亓	qihc
丌	qihp
炁	qihq
焏	qihs
稘	qiht
棋	qii
柒	qiic
杞	qiid
桤	qiie
槭	qiif
檱	qiio
栖	qiip
棲	qiiq
棄	qiis
榿	qiit
栔	qiiu
梩	qiiv
桼	qiiw
棊	qiix
棨	qiiy
櫀	qiiz
帺	qijq
釮	qijs
锜	qijt
觭	qiju
錡	qijv
鏚	qijw
鐑	qijx
袳	qikq
褀	qiks
褄	qikt
簯	qiku
簱	qikv
籏	qikw
期	qil
耆	qilc
麒	qild
脐	qilp
臍	qilq
肵	qils
竒	qilt
竐	qilu
麡	qilv
骑	qim
骐	qimp
騎	qimq
騏	qims
盀	qimt
盵	qimu
粸	qimv
闙	qimw
騹	qimx
妻	qin
娸	qinq
婍	qins
鵸	qint
鶈	qinu
鶀	qinv
器	qio
嘁	qioc
噐	qion
喰	qioo
启	qiop
啟	qioq
呚	qios
呇	qiot
呮	qiou
咠	qiov
唘	qiow
唭	qiox
啔	qioy
啓	qioz
砌	qip
碛	qipp
磧	qipq
矵	qips
碁	qipt
碕	qipu
碶	qipv
磩	qipw
磜	qipx
礘	qipy
气	qiq
欺	qiqc
齐	qiqp
氣	qiqq
齊	qiqs
気	qiqt
欫	qiqu
猉	qiqv
玂	qiqw
晵	qirq
暣	qirs
霋	qirt
岂	qis
崎	qisc
祁	qisd
屺	qise
岐	qisf
祺	qisg
祈	qisp
岓	qisq
祇	qiss
嵜	qist
禥	qisu
畦	qit
圻	qitp
畁	qitq
埼	qits
墄	qitt
芑	qiu
萁	qiuc
萋	qiud
葺	qiue
蕲	qiuf
芪	qiup
薺	qiuq
蘄	qius
芞	qiut
萕	qiuu
藄	qiuv
藒	qiuw
企	qiv
俟	qivc
乞	qivp
倛	qivq
傶	qivs
僛	qivt
琪	qiw
琦	qiwp
玘	qiwq
斉	qiws
斊	qiwt
敧	qiwu
甈	qiwv
璂	qiww
憩	qix
懠	qixn
憇	qixo
忔	qixq
忯	qixs
恓	qixt
悽	qixu
夡	qixv
愒	qixw
愭	qixx
慽	qixy
慼	qixz
讫	qiy
鳍	qiyc
颀	qiyp
訖	qiyq
頎	qiys
鰭	qiyt
諬	qiyu
鲯	qiyv
鯕	qiyw
起	qiz
迄	qizc
歧	qizp
迉	qizq
跂	qizs
攲	qizt
趞	qizu
踦	qizv
艩	qizw
扦	qja
搴	qjac
攓	qjal
攐	qjam
攑	qjan
撍	qjao
掮	qjap
扲	qjaq
拑	qjas
拪	qjat
挳	qjau
掅	qjav
揵	qjaw
掔	qjax
摼	qjay
撁	qjaz
褰	qjb
皘	qjbq
鬝	qjbs
鬜	qjbt
臤	qjcq
蚈	qjcs
蚙	qjct
軡	qjcu
蜸	qjcv
輤	qjcw
厱	qjcx
前	qjd
刋	qjdq
潜	qje
浅	qjep
淺	qjeq
潛	qjes
汘	qjet
汧	qjeu
濳	qjev
灊	qjew
纤	qjf
缱	qjfc
阡	qjfp
繾	qjfq
綪	qjfs
縴	qjft
谸	qjgq
靬	qjgs
韆	qjgt
黔	qjh
虔	qjhp
炶	qjhq
煔	qjhs
黚	qjht
椠	qji
槧	qjiq
杄	qjis
棈	qjit
榩	qjiu
槏	qjiv
橬	qjiw
檶	qjix
櫏	qjiy
钱	qjj
铅	qjjc
钎	qjjd
钤	qjje
鑓	qjjo
钳	qjjp
鉗	qjjq
鉛	qjjs
錢	qjjt
鈐	qjju
釺	qjjv
鈆	qjjw
銭	qjjx
鎆	qjjy
鏲	qjjz
签	qjk
箝	qjkc
凵	qjkp
簽	qjkq
兛	qjks
篏	qjkt
篟	qjku
籖	qjkv
籤	qjkw
肷	qjl
膁	qjlq
竏	qjls
骞	qjm
騫	qjmq
粁	qjms
騝	qjmt
騚	qjmu
牵	qjn
牽	qjnq
奷	qjns
婜	qjnt
媊	qjnu
鹐	qjnv
鳽	qjnw
嬱	qjnx
鵮	qjny
孅	qjnz
唊	qjoq
嗛	qjos
千	qjp
磏	qjpq
欠	qjq
歉	qjqp
欦	qjqq
欿	qjqs
朁	qjrq
嵌	qjs
岍	qjsp
岒	qjsq
嵰	qjss
堑	qjt
塹	qjtq
圲	qjts
圱	qjtt
墘	qjtu
壍	qjtv
芊	qju
茜	qjuc
荨	qjud
芡	qjup
蕁	qjuq
茾	qjus
葥	qjut
蒨	qjuu
蔳	qjuv
乾	qjv
佥	qjvc
倩	qjvd
仟	qjvp
僉	qjvq
伣	qjvs
仱	qjvt
乹	qjvu
俔	qjvv
偂	qjvw
亁	qjvx
傔	qjvy
儙	qjvz
瓩	qjwq
玪	qjws
悭	qjx
慊	qjxc
愆	qjxp
慳	qjxq
忴	qjxs
悓	qjxt
谦	qjy
谴	qjyp
謙	qjyq
譴	qjys
諐	qjyt
羬	qjyu
顅	qjyv
鰬	qjyw
迁	qjz
遣	qjzp
遷	qjzq
歬	qjzs
孯	qjzt
宭	qkbq
帬	qkjq
裙	qkk
裠	qkkq
箘	qkks
麇	qkl
麕	qklq
歏	qkqq
峮	qksq
囷	qkwq
群	qky
羣	qkyq
逡	qkz
夋	qkzq
踆	qkzs
撬	qma
摮	qmaq
撽	qmas
癄	qmbq
削	qmd
劁	qmdp
潐	qmeq
缲	qmf
繰	qmfq
陗	qmfs
郻	qmft
鄡	qmfu
鄥	qmfv
繑	qmfw
巧	qmg
鞘	qmgc
鞒	qmgd
敲	qmgp
鞽	qmgq
髚	qmgs
骹	qmgt
鞩	qmgu
髜	qmgv
丂	qmhq
燆	qmhs
燋	qmht
桥	qmi
樵	qmic
橇	qmip
橋	qmiq
槗	qmis
橾	qmit
櫵	qmiu
锹	qmj
鍬	qmjq
帩	qmjs
釥	qmjt
幓	qmju
幧	qmjv
鍫	qmjw
鏒	qmjx
鐈	qmjy
鐰	qmjz
箾	qmkq
勪	qmlq
瞧	qmm
睄	qmmq
嫶	qmnq
犞	qmns
喬	qmoq
喿	qmos
嘺	qmot
噭	qmou
乔	qmp
硗	qmpp
殼	qmpq
磽	qmps
殻	qmpt
硚	qmpu
毃	qmpv
磝	qmpw
碻	qmpx
礄	qmpy
礉	qmpz
壳	qms
峤	qmsc
峭	qmsp
嶠	qmsq
嵪	qmss
墝	qmtq
墧	qmts
墽	qmtt
荞	qmu
蕎	qmuq
荍	qmus
菬	qmut
藮	qmuu
侨	qmv
俏	qmvp
僑	qmvq
偢	qmvs
僺	qmvt
韒	qmwq
悄	qmx
愀	qmxc
憔	qmxd
窍	qmxp
竅	qmxq
翘	qmy
谯	qmyc
诮	qmyp
翹	qmyq
誚	qmys
譙	qmyt
頝	qmyu
顦	qmyv
跷	qmz
蹺	qmzq
踍	qmzs
趬	qmzt
趫	qmzu
蹻	qmzv
躈	qmzw
扏	qnaq
搝	qnas
赇	qnb
鼽	qnbp
賕	qnbq
虬	qnc
蝤	qncc
蚯	qncp
虯	qncq
蛷	qncs
蝵	qnct
蟗	qncu
蠤	qncv
殏	qndq
求	qne
湫	qnec
泅	qnep
汓	qneq
浗	qnes
湭	qnet
渞	qneu
湬	qnev
邱	qnf
紌	qnfq
絿	qnfs
緧	qnft
巯	qng
龜	qngq
巰	qngs
鞦	qngt
鞧	qngu
龝	qngv
秋	qnh
丠	qnhq
秌	qnhs
煪	qnht
穐	qnhu
楸	qni
朹	qniq
梂	qnis
橚	qnit
觓	qnjq
釚	qnjs
釻	qnjt
觩	qnju
銶	qnjv
裘	qnk
篍	qnkq
肍	qnlq
糗	qnm
毬	qnmq
盚	qnms
牫	qnnq
媝	qnns
鹙	qnnt
鶖	qnnu
叴	qnoq
唒	qnos
丘	qnp
皳	qnpq
酋	qnq
犰	qnqp
醔	qnqq
厹	qnsq
崷	qnss
坵	qntq
塸	qnts
芁	qnuq
莍	qnus
萩	qnut
蓲	qnuu
蘒	qnuv
俅	qnv
球	qnw
囚	qnwp
玌	qnwq
璆	qnws
恘	qnxq
恷	qnxs
鳅	qny
讐	qnyo
鰍	qnyq
讎	qnys
訄	qnyt
訅	qnyu
頄	qnyv
鮂	qnyw
鯄	qnyx
鰌	qnyy
鰽	qnyz
逑	qnz
遒	qnzp
逎	qnzq
趥	qnzs
抢	qqa
搶	qqaq
摤	qqas
摪	qqat
羌	qqb
蜣	qqc
將	qqcq
溬	qqeq
漒	qqes
繈	qqfq
繦	qqfs
强	qqg
戕	qqgc
戗	qqgp
強	qqgq
戧	qqgs
廧	qqgt
彊	qqgu
炝	qqh
熗	qqhq
枪	qqi
樯	qqip
槍	qqiq
檣	qqis
椌	qqit
锖	qqj
镪	qqjc
锵	qqjp
錆	qqjq
鏘	qqjs
鏹	qqjt
斨	qqju
鎗	qqjv
襁	qqk
篬	qqkq
腔	qql
嫱	qqn
嬙	qqnq
鶬	qqns
呛	qqo
嗆	qqoq
唴	qqos
啌	qqot
嗴	qqou
将	qqp
矼	qqpq
牄	qqps
牆	qqpt
猐	qqqq
獇	qqqs
嶈	qqsq
墙	qqt
墻	qqtq
墏	qqts
蔷	qqu
薔	qquq
蔃	qqus
蘠	qqut
玱	qqwq
瑲	qqws
羟	qqy
羥	qqyq
羗	qqys
羫	qqyt
謒	qqyu
羻	qqyv
跄	qqz
蹌	qqzq
蹡	qqzs
艢	qqzt
拳	qra
捲	qraq
搼	qras
痊	qrb
鬈	qrbp
辁	qrc
蜷	qrcp
輇	qrcq
齤	qrcs
蠸	qrct
券	qrd
奍	qrdq
泉	qre
洤	qreq
湶	qres
灥	qret
绻	qrf
綣	qrfq
絟	qrfs
縓	qrft
弮	qrgq
烇	qrhq
权	qri
權	qriq
棬	qris
椦	qrit
楾	qriu
槫	qriv
権	qriw
铨	qrj
銓	qrjq
觠	qrjs
鐉	qrjt
筌	qrk
箞	qrkq
劝	qrl
勸	qrlq
勧	qrls
駩	qrmq
闎	qrms
騡	qrmt
矔	qrmu
姾	qrnq
牷	qrns
牶	qrnt
婘	qrnu
犈	qrnv
孉	qrnw
啳	qroq
硂	qrpq
犬	qrq
犭	qrqc
醛	qrqp
狋	qrqq
峑	qrsq
巏	qrss
畎	qrt
埢	qrtq
荃	qru
葲	qruq
虇	qrus
全	qrv
佺	qrvq
圈	qrw
圏	qrwq
瑔	qrws
韏	qrwt
悛	qrx
恮	qrxq
惓	qrxs
颧	qry
诠	qryp
顴	qryq
詮	qrys
犮	qryt
鳈	qryu
鰁	qryv
跧	qrzq
踡	qrzs
宆	qsbq
蛩	qsc
蛬	qscq
邛	qsf
煢	qshq
焭	qshs
焪	qsht
熍	qshu
桏	qsiq
橩	qsis
銎	qsj
卭	qsjq
筇	qsk
笻	qskq
睘	qsmq
瞏	qsms
嬛	qsnq
茕	qsu
藑	qsuq
藭	qsus
儝	qsvq
琼	qsw
瓊	qswq
琁	qsws
璚	qswt
瓗	qswu
穷	qsx
穹	qsxp
窮	qsxq
惸	qsxs
憌	qsxt
竆	qsxu
跫	qsz
赹	qszq
舼	qszs
挈	qta
癿	qtbq
厒	qtcq
蛪	qtcs
切	qtd
洯	qteq
淁	qtes
郄	qtf
匧	qtfq
聺	qtfs
且	qth
稧	qthq
穕	qths
栔	qtiq
椄	qtis
锲	qtj
鍥	qtjq
帹	qtjs
箧	qtk
篋	qtkq
笡	qtks
籡	qtkt
妾	qtn
嗛	qtoq
猰	qtqq
朅	qtrq
茄	qtu
苆	qtuq
窃	qtx
惬	qtxc
慊	qtxd
怯	qtxp
竊	qtxq
愜	qtxs
悏	qtxt
鯜	qtyq
趄	qtz
疌	qtzq
跙	qtzs
踥	qtzt
抾	quaq
癯	qub
髷	qubq
蛆	quc
蛐	qucc
衢	qucd
蠼	quce
龋	qucp
齲	qucq
衐	qucs
蚼	quct
軥	qucu
蝺	qucv
螶	qucw
蟝	qucx
忂	qucy
蠷	qucz
刞	qudq
浀	queq
淭	ques
灈	quet
区	quf
區	qufq
匤	qufs
阹	quft
紶	qufu
絇	qufv
戵	qugq
黢	quh
焌	quhq
煀	quhs
爠	quht
渠	qui
欋	quiq
欔	quis
觑	quj
覷	qujq
斪	qujs
覰	qujt
覻	quju
鑺	qujv
袪	qukq
筁	quks
籧	qukt
曲	qul
朐	qulc
劬	qulp
胠	qulq
胊	quls
竘	qult
耝	qulu
竬	qulv
臞	qulw
驱	qum
麴	qumc
氍	qumd
鼁	qumo
阒	qump
驅	qumq
麯	qums
闃	qumt
粬	qumu
駆	qumv
麹	qumw
駈	qumx
閴	qumy
麮	qumz
娶	qun
鸲	qunp
鴝	qunq
鶌	quns
鸜	qunt
呿	quoq
屈	qup
磲	qupp
欪	quqq
去	qus
岖	qusc
祛	qusd
躯	qusp
軀	qusq
嶇	quss
厺	qust
岴	qusu
唟	qusv
鼩	qusw
坥	qutq
苣	quu
蘧	quuc
蕖	quup
菃	quuq
葋	quus
佢	quvq
佉	quvs
伹	quvt
璩	quw
璖	quwq
敺	quws
憈	quxq
取	quy
诎	quyp
詘	quyq
翑	quys
詓	quyt
誳	quyu
魼	quyv
翵	quyw
鰸	quyx
鱋	quyy
趣	quz
瞿	quzc
趋	quzp
趨	quzq
迲	quzs
趍	quzt
躣	quzu
掐	qwa
抲	qwaq
拤	qwas
揢	qwat
擖	qwau
冾	qwbq
夹	qwd
殎	qwdq
洽	qwe
匼	qwfq
髂	qwg
鞐	qwgq
帢	qwjq
袷	qwk
胢	qwlq
硈	qwpq
磍	qwps
酠	qwqq
峠	qwsq
圶	qwtq
葜	qwu
恰	qwx
愘	qwxq
跒	qwzq
擒	qxa
揿	qxap
撳	qxaq
扲	qxas
抋	qxat
捦	qxau
搇	qxav
寝	qxb
寢	qxbq
寑	qxbs
寖	qxbt
瘽	qxbu
寴	qxbv
螓	qxc
蚙	qxcq
螼	qxcs
蠄	qxct
沁	qxe
溱	qxep
澿	qxeq
瀙	qxes
耹	qxfq
綅	qxfs
庈	qxgq
靲	qxgs
秦	qxh
檎	qxi
梫	qxiq
钦	qxj
锓	qxjp
親	qxjq
鋟	qxjs
鈙	qxjt
鈫	qxju
斳	qxjv
衾	qxk
笉	qxkq
亲	qxl
勤	qxlp
肣	qxlq
矜	qxm
矝	qxmq
骎	qxms
駸	qxmt
媇	qxnq
嫀	qxns
鳹	qxnt
鵭	qxnu
吣	qxo
噙	qxoc
嗪	qxop
唚	qxoq
吢	qxos
欽	qxqq
昑	qxrq
嵚	qxsq
嵰	qxss
嶜	qxst
嶔	qxsu
坅	qxtq
埐	qxts
芹	qxu
芩	qxup
菦	qxuq
菣	qxus
菳	qxut
藽	qxuu
禽	qxv
侵	qxvp
琴	qxw
珡	qxwq
琹	qxws
覃	qxx
忴	qxxq
慬	qxxs
懄	qxxt
懃	qxxu
誛	qxyq
顉	qxys
鮼	qxyt
赾	qxzq
雂	qxzs
擎	qya
掅	qyaq
擏	qyas
凊	qybq
寈	qybs
轻	qyc
蜻	qycp
輕	qycq
軽	qycs
剠	qydq
殑	qyds
清	qye
淸	qyeq
渹	qyes
漀	qyet
濪	qyeu
綮	qyf
罄	qyfp
郬	qyfq
綪	qyfs
庆	qyg
庼	qygq
廎	qygs
黥	qyh
檠	qyi
檾	qyiq
棾	qyis
樈	qyit
櫦	qyiu
卿	qyj
親	qyjq
錆	qyjs
鑋	qyjt
勍	qylq
啨	qyoq
磬	qyp
殸	qypq
硘	qyps
碃	qypt
青	qyq
氰	qyqc
氢	qyqp
氫	qyqq
靑	qyqs
靘	qyqt
晴	qyr
暒	qyrq
甠	qysq
埥	qytq
苘	qyu
葝	qyuq
倾	qyv
傾	qyvq
儬	qyvs
圊	qyw
情	qyx
慶	qyxq
夝	qyxs
请	qyy
鲭	qyyc
謦	qyyd
顷	qyyp
頃	qyyq
請	qyys
鯖	qyyt
罖	rasq
扰	rca
擾	rcaq
绕	rcf
繞	rcfq
隢	rcfs
穘	rchq
桡	rci
橈	rciq
襓	rckq
娆	rcn
嬈	rcnq
饶	rcs
饒	rcsq
荛	rcu
蕘	rcuq
遶	rczq
捼	reaq
渃	reeq
热	reh
熱	rehq
喏	reo
惹	rex
揉	rfa
宍	rfbq
蝚	rfcq
輮	rfcs
渘	rfeq
鞣	rfg
煣	rfhq
柔	rfi
楺	rfiq
禸	rfjq
鍒	rfjs
脜	rflq
腬	rfls
糅	rfm
粈	rfmq
騥	rfms
媃	rfnq
鶔	rfns
肉	rfr
厹	rfsq
葇	rfuq
瑈	rfwq
韖	rfws
瓇	rfwt
鰇	rfyq
譳	rfys
蹂	rfz
扨	rgaq
轫	rgc
軔	rgcq
刃	rgd
刄	rgdq
纫	rgf
紉	rgfq
纴	rgfs
紝	rgft
絍	rgfu
綛	rgfv
靭	rggq
靱	rggs
稔	rgh
秂	rghq
秹	rghs
朲	rgiq
杒	rgis
栣	rgit
栠	rgiu
梕	rgiv
棯	rgiw
釰	rgjq
釼	rgjs
鈓	rgjt
銋	rgju
衽	rgk
袵	rgkq
肕	rglq
腍	rgls
妊	rgn
牣	rgnq
姙	rgns
鵀	rgnt
壬	rgp
饪	rgs
飪	rgsq
屻	rgss
祍	rgst
躵	rgsu
餁	rgsv
荏	rgu
芢	rguq
荵	rgus
菍	rgut
人	rgv
仁	rgvc
亻	rgvd
仞	rgve
任	rgvp
仭	rgvq
韧	rgw
韌	rgwq
忍	rgx
忈	rgxq
忎	rgxs
认	rgy
認	rgyq
讱	rgys
訒	rgyt
魜	rgyu
攘	rha
鬤	rhbq
瀼	rheq
纕	rhfq
瓤	rhg
穰	rhh
穣	rhhq
爙	rhhs
勷	rhlq
嚷	rho
獽	rhqq
禳	rhs
壤	rht
壌	rhtq
蘘	rhuq
儴	rhvq
懹	rhxq
让	rhy
讓	rhyq
譲	rhys
躟	rhzq
釰	rijq
釼	rijs
鈤	rijt
衵	rikq
驲	rimq
馹	rims
氜	riqq
日	rir
囸	riwq
润	rke
潤	rkeq
橍	rkiq
膶	rklq
闰	rkm
閏	rkmq
閠	rkms
瞤	rkmt
髯	rlb
髥	rlbq
蚺	rlc
蚦	rlcq
繎	rlfq
然	rlh
燃	rlhp
熯	rlhq
染	rli
橪	rliq
衻	rlkq
袇	rlks
袡	rlkt
肰	rllq
姌	rlnq
媣	rlns
呥	rloq
嘫	rlos
冉	rlt
冄	rltq
苒	rlu
蒅	rluq
珃	rlwq
挼	roaq
捼	roas
渃	roeq
鄀	rofq
弱	rog
焫	rohq
爇	rohs
楉	roiq
箬	rok
篛	rokq
婼	ronq
鶸	rons
嵶	rosq
若	rou
蒻	rouq
偌	rov
叒	royq
鰙	roys
鰯	royt
撋	rraq
软	rrc
軟	rrcq
輭	rrcs
耎	rreq
阮	rrf
緛	rrfq
檽	rriq
朊	rrl
腝	rrlq
媆	rrnq
碝	rrpq
礝	rrps
堧	rrtq
壖	rrts
偄	rrvq
瑌	rrwq
瓀	rrws
搑	rsaq
搈	rsas
容	rsb
宂	rsbq
融	rsc
蝾	rscp
蠑	rscq
軵	rscs
螎	rsct
溶	rse
瀜	rseq
绒	rsf
絨	rsfq
縙	rsfs
戎	rsg
熔	rsh
烿	rshq
穁	rshs
穃	rsht
爃	rshu
榕	rsi
榮	rsiq
栄	rsis
榵	rsit
槦	rsiu
镕	rsjq
鎔	rsjs
褣	rskq
肜	rsl
冗	rsm
毧	rsmq
駥	rsms
氄	rsmt
媶	rsnq
嫆	rsns
嬫	rsnt
狨	rsq
曧	rsrq
嵘	rss
嶸	rssq
峵	rsss
嵤	rsst
坈	rstq
荣	rsu
茸	rsuc
蓉	rsup
茙	rsuq
傇	rsvq
傛	rsvs
瑢	rswq
羢	rsyq
扖	ruaq
挐	ruas
擩	ruat
辱	ruc
蠕	rucp
蝡	rucq
汝	rue
溽	ruec
濡	rued
洳	ruep
渪	rueq
缛	ruf
縟	rufq
邚	rufs
鄏	ruft
繻	rufu
杁	ruiq
桇	ruis
檽	ruit
铷	ruj
銣	rujq
帤	rujs
褥	ruk
襦	rukp
袽	rukq
筎	ruks
肗	rulq
如	run
鳰	runq
媷	runs
鴑	runt
嬬	runu
鴽	runv
嚅	ruo
吺	ruoq
嗕	ruos
獳	ruqq
醹	ruqs
入	rur
曘	rurq
嶿	rusq
茹	ruu
薷	ruuc
蓐	ruup
蒘	ruuq
蕠	ruus
乳	ruv
儒	ruvp
侞	ruvq
颥	ruy
顬	ruyq
鱬	ruys
孺	ruz
抐	rvaq
蚋	rvc
蜹	rvcq
兌	rveq
兊	rves
汭	rvet
緌	rvfq
繠	rvfs
枘	rvi
桵	rviq
橤	rvis
锐	rvj
銳	rvjq
鋭	rvjs
鏸	rvjt
笍	rvkq
睿	rvm
甤	rvsq
壡	rvtq
蕊	rvu
蕤	rvuc
芮	rvup
苼	rvuq
蕋	rvus
蘃	rvut
蘂	rvuu
瑞	rvw
惢	rvxq
叡	rvyq
扔	rza
陾	rzfq
礽	rzsq
芿	rzuq
仍	rzv
辸	rzzq
撒	saa
挲	saap
挱	saaq
摋	saas
攃	saat
洒	sae
灑	saeq
泧	saes
潵	saet
飒	saf
颯	safq
隡	safs
纚	saft
靸	sagq
鞈	sags
卅	sah
櫒	saiq
钑	sajq
鈒	sajs
鏾	sajt
脎	sal
馺	samq
萨	sau
薩	sauq
蕯	saus
訯	sayq
躠	sazq
扫	sca
搔	scap
掃	scaq
掻	scas
瘙	scb
螦	sccq
溞	sceq
缫	scf
繅	scfq
繰	scfs
颾	scft
髞	scgq
臊	scl
骚	scm
騷	scmq
氉	scms
騒	scmt
矂	scmu
嫂	scn
埽	sct
慅	scxq
懆	scxs
鳋	scy
鰠	scyq
鱢	scys
揌	sdaq
赛	sdb
賽	sdbq
簺	sdkq
腮	sdl
毢	sdmq
毸	sdms
噻	sdo
嗮	sdoq
嘥	sdos
塞	sdt
僿	sdvq
愢	sdxq
鳃	sdy
鰓	sdyq
顋	sdys
拺	seaq
摵	seas
擌	seat
瘷	sebq
轖	secq
涩	see
澀	seeq
洓	sees
渋	seet
澁	seeu
濏	seev
濇	seew
瀒	seex
繬	sefq
飋	sefs
廧	segq
穑	seh
穡	sehq
穯	sehs
栜	seiq
铯	sej
銫	sejq
鎍	sejs
鏼	sejt
粣	semq
閪	sems
闟	semt
嗇	seoq
雭	serq
色	ses
啬	sesp
塞	set
薔	seuq
僿	sevq
瑟	sew
琗	sewq
璱	sews
懎	sexq
譅	seyq
鱪	seys
歮	sezq
歰	sezs
搜	sfa
擞	sfap
擻	sfaq
捒	sfas
捜	sfat
摉	sfau
摗	sfav
撨	sfaw
凁	sfbq
瘶	sfbs
螋	sfc
溲	sfe
飕	sff
颼	sffq
鄋	sffs
颾	sfft
廋	sfgq
廀	sfgs
棷	sfiq
櫢	sfis
锼	sfj
鎪	sfjq
鏉	sfjs
籔	sfkq
瞍	sfm
騪	sfmq
嗽	sfo
嗾	sfoc
嗖	sfop
欶	sfqq
獀	sfqs
醙	sfqt
馊	sfs
餿	sfsq
薮	sfu
藪	sfuq
蓃	sfus
蒐	sfut
傁	sfvq
叟	sfy
叜	sfyq
艘	sfz
森	sgi
椮	sgiq
槮	sgis
襂	sgkq
搡	sha
桑	shi
桒	shiq
槡	shis
鎟	shjq
褬	shkq
嗓	sho
喪	shoq
磉	shp
丧	shs
颡	shy
顙	shyq
撕	sia
凘	sibq
寺	sic
厮	sicc
蛳	sicp
螄	sicq
厠	sics
蜤	sict
蟴	sicu
蟖	sicv
死	sid
汜	sie
泗	siec
澌	sied
兕	siep
亖	sieq
泤	sies
泀	siet
洠	sieu
洍	siev
涘	siew
瀃	siex
纟	sif
缌	sifc
糸	sifp
絲	sifq
緦	sifs
糹	sift
飔	sifu
颸	sifv
廝	sigq
丝	sih
私	sihp
虒	sihq
燍	sihs
杫	siiq
柶	siis
枱	siit
梩	siiu
楒	siiv
榹	siiw
斯	sij
鐁	sijo
锶	sijp
鍶	sijq
釲	sijs
覗	sijt
鈻	siju
鉰	sijv
鈶	sijw
銉	sijx
銯	sijy
鋖	sijz
笥	sik
簛	sikq
耜	sil
耛	silq
竢	sils
驷	sim
駟	simq
騃	sims
騦	simt
姒	sin
鸶	sinp
鷥	sinq
牭	sins
娰	sint
媤	sinu
司	sio
嗣	sioc
咝	siod
嘶	siop
噝	sioq
磃	sipq
食	sis
饲	sisc
厶	sisd
祀	sise
巳	sisp
飼	sisq
飴	siss
厼	sist
飤	sisu
禗	sisv
罳	sisw
禠	sisx
禩	sisy
鼶	sisz
蕬	siuq
蕼	sius
似	siv
俟	sivc
伺	sivp
佀	sivq
価	sivs
俬	sivt
偲	sivu
傂	sivv
儩	sivw
四	siw
思	six
恖	sixq
愢	sixs
肆	siy
肂	siyq
鯣	siys
孠	sizq
貄	sizs
损	ska
損	skaq
扻	skas
搎	skat
摌	skau
潠	skeq
榫	ski
槂	skiq
鎨	skjq
笋	skk
筍	skkq
箰	skks
簨	skkt
鶽	sknq
喰	skoq
狲	skq
猻	skqq
飧	sks
飱	sksq
荪	sku
蓀	skuq
蕵	skus
薞	skut
孙	skz
隼	skzp
孫	skzq
鬖	slbq
潵	sleq
繖	slfq
三	slh
帴	sljq
厁	sljs
鏒	sljt
鏾	slju
毵	slm
糁	slmp
毿	slmq
糝	slms
閐	slmt
毶	slmu
糂	slmv
糤	slmw
糣	slmx
犙	slnq
叁	sls
馓	slsc
彡	slsp
參	slsq
饊	slss
壭	slst
叄	slsu
叅	slsv
伞	slv
仨	slvp
傘	slvq
仐	slvs
俕	slvt
散	slw
弎	slyq
挲	soa
挱	soaq
摍	soas
蜶	socq
溹	soeq
溑	soes
索	sof
缩	sofp
縮	sofq
縒	sofs
所	soh
梭	soi
桫	soip
锁	soj
鎖	sojq
鎍	sojs
鎻	sojt
鏁	soju
褨	sokq
簑	soks
簔	sokt
睃	som
娑	son
嫅	sonq
唆	soo
嗦	sooc
嗍	sood
唢	soop
嗩	sooq
獕	soqq
暛	sorq
莎	sou
蓑	soup
莏	souq
傞	sovq
琐	sow
瑣	sowq
琑	sows
璅	sowt
惢	soxq
羧	soy
鮻	soyq
逤	sozq
趖	sozs
痠	srbq
匴	srfq
算	srk
笇	srkq
筭	srks
篹	srkt
酸	srq
狻	srqp
祘	srsq
蒜	sru
捒	ssaq
揔	ssas
摗	ssat
宋	ssb
凇	ssbp
鬆	ssbq
淞	sse
漎	sseq
濍	sses
耸	ssf
聳	ssfq
庺	ssgq
松	ssi
枩	ssiq
枀	ssis
柗	ssit
梥	ssiu
棇	ssiv
楤	ssiw
檧	ssix
鎹	ssjq
竦	ssl
駷	ssmq
娀	ssnq
吅	ssoq
硹	sspq
崧	sss
嵩	sssp
嵷	sssq
餸	ssss
菘	ssu
倯	ssvq
傱	ssvs
怂	ssx
悚	ssxc
忪	ssxp
慫	ssxq
愡	ssxs
愯	ssxt
憽	ssxu
颂	ssy
讼	ssyc
诵	ssyp
訟	ssyq
頌	ssys
誦	ssyt
送	ssz
摵	suaq
宿	sub
殐	sudq
溯	sue
涑	suep
泝	sueq
洬	sues
溸	suet
潥	sueu
潚	suev
素	suf
缩	sufp
縮	sufq
縤	sufs
穌	suhq
稡	suhs
梀	suiq
棴	suis
榡	suit
樕	suiu
樎	suiv
橚	suiw
櫯	suix
夙	suj
觫	sujp
鋉	sujq
簌	suk
膆	sulq
粟	sum
粛	sumq
骕	sums
驌	sumt
鹔	sunq
嫊	suns
鷫	sunt
嗉	suo
囌	suoq
碿	supq
酥	suq
甦	susq
餗	suss
塑	sut
圱	sutq
埣	suts
塐	sutt
苏	suu
蔌	suup
蘇	suuq
莤	suus
藗	suut
蘓	suuu
俗	suv
僳	suvp
傃	suvq
玊	suwq
珟	suws
璛	suwt
愫	sux
窣	suxq
愬	suxs
憟	suxt
诉	suy
谡	suyc
稣	suyd
肃	suyp
訴	suyq
肅	suys
謖	suyt
鯂	suyu
鱐	suyv
速	suz
遡	suzq
趚	suzs
遬	suzt
蹜	suzu
賥	svbq
虽	svc
濉	sve
亗	sveq
浽	sves
滖	svet
澻	sveu
瀡	svev
随	svf
隧	svfc
绥	svfd
隋	svfp
綏	svfq
隨	svfs
缞	svft
縗	svfu
繀	svfv
旞	svfw
繐	svfx
繸	svfy
髓	svg
鞖	svgq
髄	svgs
穗	svh
燧	svhp
煫	svhq
穂	svhs
熣	svht
穟	svhu
檖	sviq
鐆	svjq
鏸	svjs
鐩	svjt
襚	svkq
膸	svlq
眭	svm
睢	svmp
睟	svmq
毸	svms
娞	svnq
嬘	svns
哸	svoq
嗺	svos
碎	svp
砕	svpq
岁	svs
祟	svsp
嵗	svsq
禭	svss
埣	svtq
荽	svu
芕	svuq
荾	svus
倠	svvq
璲	svwq
瓍	svws
韢	svwt
谇	svy
誶	svyq
譢	svys
遂	svz
邃	svzp
歲	svzq
雖	svzs
夊	svzt
遀	svzu
歳	svzv
鬙	szbq
僧	szv
挞	taa
撻	taaq
搨	taas
它	tab
沓	tae
漯	taec
溻	taep
涾	taeq
溚	taes
澾	taet
濌	taeu
鞈	tagq
鞜	tags
鞳	tagt
榻	tai
榙	taiq
橽	tais
铊	taj
鉈	tajq
錔	tajs
鎑	tajt
鎉	taju
褟	takq
襨	taks
闼	tam
闥	tamq
粏	tams
阘	tamt
毾	tamu
闒	tamv
闟	tamw
她	tan
牠	tanq
嗒	tao
嚃	taoq
嚺	taos
獭	taq
獺	taqq
狧	taqs
祂	tasq
崉	tass
禢	tast
塔	tat
塌	tatp
墖	tatq
他	tav
侤	tavq
傝	tavs
鳎	tay
鰨	tayq
誻	tays
鮙	tayt
譶	tayu
踏	taz
趿	tazc
遢	tazd
蹋	tazp
遝	tazq
蹹	tazs
躢	tazt
掏	tca
抭	tcaq
搯	tcas
匋	tcbq
蜪	tccq
轁	tccs
套	tcd
夲	tcdq
夵	tcds
涛	tce
淘	tcec
洮	tced
滔	tcep
濤	tceq
涭	tces
陶	tcf
绦	tcfp
绹	tcfq
絛	tcfs
綯	tcft
縧	tcfu
縚	tcfv
鼗	tcg
弢	tcgq
鞀	tcgs
鞉	tcgt
鞱	tcgu
燾	tchq
桃	tci
梼	tciq
槄	tcis
檮	tcit
幍	tcjq
鋾	tcjs
裪	tckq
駣	tcmq
騊	tcms
嫍	tcnq
叨	tco
啕	tcop
咷	tcoq
醄	tcqq
饕	tcs
祹	tcsq
飸	tcss
饀	tcst
萄	tcu
韬	tcw
韜	tcwq
瑫	tcws
慆	tcxq
讨	tcy
討	tcyq
詜	tcys
謟	tcyt
逃	tcz
迯	tczq
抬	tda
擡	tdaq
冭	tdbq
大	tdd
太	tddp
夳	tddq
奤	tdds
泰	tde
汰	tdep
汏	tdeq
汱	tdes
溙	tdet
邰	tdf
颱	tdfq
炱	tdh
炲	tdhq
燤	tdhs
枱	tdiq
檯	tdis
钛	tdj
鈦	tdjq
箈	tdkq
籉	tdks
胎	tdl
肽	tdlp
骀	tdm
駘	tdmq
嬯	tdnq
台	tdo
酞	tdq
旲	tdrq
坮	tdtq
苔	tdu
薹	tdup
菭	tduq
儓	tdvq
囼	tdwq
珆	tdws
斄	tdwt
态	tdx
態	tdxq
忕	tdxs
忲	tdxt
鲐	tdy
鮐	tdyq
跆	tdz
臺	tdzq
孡	tdzs
舦	tdzt
貸	tebq
蟘	tecq
铽	tej
鋱	tejq
脦	telq
特	ten
犆	tenq
忑	tex
慝	texc
忒	texp
投	tfa
头	tfd
斢	tfdq
紏	tffq
緰	tffs
骰	tfg
黈	tfhq
鋀	tfjq
鍮	tfjs
妵	tfnq
媮	tfns
婾	tfnt
飳	tfsq
亠	tft
埱	tftq
蘣	tfuq
偷	tfv
偸	tfvq
敨	tfwq
頭	tfyq
透	tfz
搪	tha
摥	thaq
螗	thc
螳	thcp
蝪	thcq
赯	thcs
劏	thdq
汤	the
溏	thec
淌	thep
湯	theq
漟	thes
灙	thet
鄌	thfq
隚	thfs
鞺	thgq
鼞	thgs
烫	thh
燙	thhq
煻	thhs
爣	thht
棠	thi
樘	thip
榶	thiq
橖	this
帑	thj
镗	thjc
铴	thjp
鏜	thjq
鐋	thjs
镋	thjt
鎲	thju
鎕	thjv
钂	thjw
篖	thkq
膛	thl
耥	thlp
膅	thlq
糖	thm
糃	thmq
糛	thms
闛	thmt
矘	thmu
鶶	thnq
唐	tho
啺	thoq
嘡	thos
磄	thpq
醣	thq
曭	thrq
躺	ths
嵣	thsq
禟	thss
餹	thst
饄	thsu
堂	tht
塘	thtp
坣	thtq
蓎	thuq
薚	thus
倘	thv
傥	thvp
儻	thvq
伖	thvs
偒	thvt
傏	thvu
瑭	thw
惝	thx
愓	thxq
戃	thxs
羰	thy
趟	thz
踼	thzq
蹚	thzs
提	tia
挮	tiaq
掦	tias
揥	tiat
擿	tiau
髰	tibq
鬀	tibs
鬄	tibt
厗	ticq
徥	tics
徲	tict
剔	tid
剃	tidp
奃	tidq
殢	tids
涕	tie
洟	tieq
渧	ties
漽	tiet
绨	tif
缇	tifp
綈	tifq
緹	tifs
體	tigq
骵	tigs
戻	tihq
稊	tihs
梯	tii
桋	tiiq
锑	tij
銻	tijq
鍗	tijs
裼	tik
笹	tikq
褆	tiks
褅	tikt
籊	tiku
眣	timq
睼	tims
騠	timt
鹈	tin
鵜	tinq
媞	tins
媂	tint
鶗	tinu
鶙	tinv
鷈	tinw
鷉	tinx
鷤	tiny
啼	tio
嚏	tiop
啑	tioq
嗁	tios
嚔	tiot
屉	tip
屜	tipq
屟	tips
碮	tipt
磃	tipu
醍	tiq
歒	tiqq
替	tir
罤	tisq
崹	tiss
躰	tist
禔	tisu
軆	tisv
禵	tisw
荑	tiu
苐	tiuq
蕛	tius
薙	tiut
体	tiv
倜	tivp
俶	tivq
偍	tivs
珶	tiwq
瑅	tiws
瓋	tiwt
惕	tix
悌	tixp
悐	tixq
惖	tixs
惿	tixt
题	tiy
題	tiyq
鳀	tiys
謕	tiyt
鮷	tiyu
鯷	tiyv
踢	tiz
逖	tizc
蹄	tizp
逷	tizq
遆	tizs
趧	tizt
蹏	tizu
趯	tizv
掭	tja
搷	tjaq
兲	tjbq
痶	tjbs
賟	tjbt
天	tjd
殄	tjdp
添	tje
沺	tjeq
淟	tjes
湉	tjet
紾	tjfq
緂	tjfs
甜	tjg
甛	tjgq
黇	tjhq
鈿	tjjq
铦	tjjs
觍	tjjt
銛	tjju
覥	tjjv
銽	tjjw
錪	tjjx
腆	tjl
胋	tjlq
阗	tjm
闐	tjmq
盷	tjms
睓	tjmt
奵	tjnq
婖	tjns
鴫	tjnt
鷏	tjnu
鷆	tjnv
呑	tjoq
唺	tjos
屇	tjpq
碵	tjps
磌	tjpt
靔	tjqq
酟	tjqs
靝	tjqt
晪	tjrq
舔	tjs
餂	tjsq
舚	tjss
田	tjt
畋	tjtc
填	tjtp
畑	tjtq
畠	tjts
塡	tjtt
菾	tjuq
倎	tjvq
琠	tjwq
瑱	tjws
璳	tjwt
恬	tjx
忝	tjxp
悿	tjxq
窴	tjxs
軘	tkcq
蛌	tkcs
氽	tke
涒	tkeq
庉	tkgq
屯	tkh
焞	tkhq
黗	tkhs
褪	tkk
臀	tkl
豚	tklp
朜	tklq
臋	tkls
吞	tko
呑	tkoq
啍	tkos
噋	tkot
暾	tkr
旽	tkrq
霕	tkrs
饨	tks
飩	tksq
豘	tkss
坉	tktq
芚	tkuq
囤	tkw
瓲	tkwq
忳	tkxq
憞	tkxs
鲀	tkyq
魨	tkys
探	tla
摊	tlap
攤	tlaq
擹	tlas
贪	tlb
痰	tlbc
瘫	tlbp
貪	tlbq
癱	tlbs
痑	tlbt
潭	tle
澹	tlec
滩	tlep
灘	tleq
湠	tles
潬	tlet
郯	tlf
緂	tlfq
罈	tlfs
繵	tlft
罎	tlfu
弹	tlg
彈	tlgq
弾	tlgs
炭	tlh
燂	tlhq
檀	tli
榃	tliq
橝	tlis
钽	tlj
锬	tljp
鉭	tljq
錟	tljs
袒	tlk
襢	tlkq
毯	tlm
婒	tlnq
叹	tlo
嘆	tloq
啴	tlos
嗿	tlot
嘾	tlou
嘽	tlov
碳	tlp
歎	tlqq
醈	tlqs
醓	tlqt
醰	tlqu
昙	tlr
曇	tlrq
暺	tlrs
舑	tlsq
舕	tlss
坦	tlt
坍	tltc
坛	tltp
壇	tltq
埮	tlts
墰	tltt
墵	tltu
壜	tltv
菼	tluq
藫	tlus
倓	tlvq
傝	tlvs
僋	tlvt
儃	tlvu
璮	tlwq
忐	tlx
覃	tlxp
怹	tlxq
惔	tlxs
憛	tlxt
憳	tlxu
憻	tlxv
谈	tly
谭	tlyp
談	tlyq
譚	tlys
顃	tlyt
譠	tlyu
貚	tlzq
挑	tma
髫	tmb
宨	tmbq
龆	tmc
蜩	tmcp
齠	tmcq
斢	tmdq
聎	tmfq
絩	tmfs
庣	tmgq
鞗	tmgs
条	tmi
條	tmiq
朷	tmis
樤	tmit
銚	tmjq
覜	tmjs
鋚	tmjt
鎥	tmju
笤	tmk
朓	tmlq
脁	tmls
眺	tmm
粜	tmmp
糶	tmmq
嬥	tmnq
旫	tmrq
晀	tmrs
祧	tms
岧	tmsq
岹	tmss
祒	tmst
苕	tmu
蓧	tmuq
芀	tmus
萔	tmut
蓚	tmuu
蓨	tmuv
佻	tmv
窕	tmx
恌	tmxq
窱	tmxs
调	tmy
鲦	tmyp
調	tmyq
鰷	tmys
誂	tmyt
鯈	tmyu
跳	tmz
迢	tmzp
趒	tmzq
托	toa
拓	toac
拖	toap
扡	toaq
拕	toas
挩	toat
捝	toau
搨	toav
撱	toaw
彵	tocq
沱	toe
汑	toeq
沰	toes
涶	toet
陀	tof
阤	tofq
陁	tofs
紽	toft
庹	tog
椭	toi
柁	toic
橐	toid
柝	toip
橢	toiq
杔	tois
杝	toit
楕	toiu
槖	toiv
鉈	tojq
鋖	tojs
箨	tok
籜	tokq
袥	toks
袉	tokt
脱	tol
脫	tolq
驼	tom
鼍	tomc
驝	tomn
驒	tomo
驮	tomp
馱	tomq
駝	toms
鼉	tomt
毤	tomu
馲	tomv
毻	tomw
駄	tomx
駞	tomy
騨	tomz
妥	ton
鸵	tonp
鴕	tonq
媠	tons
嫷	tont
鵎	tonu
唾	too
咃	tooq
咜	toos
啴	toot
嘽	toou
乇	top
砣	topp
砤	topq
碢	tops
酡	toq
狏	toqq
饦	tosq
岮	toss
飥	tost
嶞	tosu
鼧	tosv
坨	tot
堶	totq
莌	touq
萚	tous
蘀	tout
佗	tov
仛	tovq
侂	tovs
侻	tovt
讬	toyq
託	toys
詑	toyt
魠	toyu
説	toyv
鮀	toyw
鮵	toyx
鰖	toyy
跎	toz
跅	tozq
抟	tra
摶	traq
剸	trdq
湍	tre
湪	treq
漙	tres
煓	trhq
槫	triq
檲	tris
鏄	trjq
褖	trkq
篿	trks
糰	trmq
鷒	trnq
鷻	trns
猯	trqq
彖	trs
疃	trt
塼	trtq
畽	trts
墥	trtt
团	trw
團	trwq
団	trws
圕	trwt
慱	trxq
貒	trzq
捅	tsa
痛	tsb
痌	tsbq
蚒	tscq
衕	tscs
赨	tsct
潼	tse
浵	tseq
统	tsf
統	tsfq
絧	tsfs
綂	tsft
庝	tsgq
炵	tshq
烔	tshs
秱	tsht
熥	tshu
燑	tshv
穜	tshw
桶	tsi
桐	tsip
樋	tsiq
橦	tsis
铜	tsj
銅	tsjq
鉖	tsjs
鉵	tsjt
筒	tsk
筩	tskq
童	tsl
勭	tslq
朣	tsls
膧	tslt
瞳	tsm
眮	tsmq
粡	tsms
氃	tsmt
犝	tsnq
同	tso
嗵	tsop
哃	tsoq
砼	tsp
硧	tspq
酮	tsq
狪	tsqq
獞	tsqs
晍	tsrq
曈	tsrs
彤	tss
峂	tssq
峝	tsss
餇	tsst
茼	tsu
蓪	tsuq
仝	tsv
佟	tsvp
偅	tsvq
囲	tswq
恸	tsx
慟	tsxq
憅	tsxs
詷	tsyq
鲖	tsys
鮦	tsyt
通	tsz
贴	ttb
貼	ttbq
蛈	ttcq
聑	ttfq
铁	ttj
帖	ttjp
鐵	ttjq
鉄	ttjs
銕	ttjt
鐡	ttju
驖	ttmq
呫	ttoq
餮	tts
飻	ttsq
萜	ttu
僣	ttvq
怗	ttxq
跕	ttzq
捈	tuaq
捸	tuas
揬	tuat
摕	tuau
宊	tubq
凃	tubs
痜	tubt
瘏	tubu
徒	tuc
兔	tud
涂	tue
汢	tueq
兎	tues
涋	tuet
湥	tueu
潳	tuev
庩	tugq
廜	tugs
秃	tuh
禿	tuhq
稌	tuhs
梌	tuiq
檡	tuis
钍	tuj
釷	tujq
鈯	tujs
鋀	tujt
鋵	tuju
鍎	tujv
凸	tuk
筡	tukq
腯	tulq
駼	tumq
鵚	tunq
鵌	tuns
鵵	tunt
鶟	tunu
鷋	tunv
鷵	tunw
吐	tuo
唋	tuoq
啚	tuos
屠	tup
酴	tuq
峹	tusq
嵞	tuss
嶀	tust
鼵	tusu
土	tut
堍	tutp
塗	tutq
圡	tuts
堗	tutt
墿	tutu
荼	tuu
菟	tuup
莵	tuuq
葖	tuus
蒤	tuut
图	tuw
圖	tuwq
図	tuws
瑹	tuwt
圗	tuwu
突	tux
怢	tuxq
悇	tuxs
馟	tuxt
途	tuz
迌	tuzq
趃	tuzs
跿	tuzt
推	tva
蜕	tvc
蛻	tvcq
聉	tvfq
隤	tvfs
弚	tvgq
骽	tvgs
魋	tvgt
煺	tvh
穨	tvhq
橔	tviq
褪	tvk
腿	tvl
駾	tvmq
娧	tvnq
墤	tvtq
蓷	tvuq
藬	tvus
蘈	tvut
俀	tvvq
侻	tvvs
僓	tvvt
忒	tvx
颓	tvy
頹	tvyq
尵	tvys
頽	tvyt
頺	tvyu
讉	tvyv
退	tvz
蹆	tvzq
蹪	tvzs
挺	tya
厅	tyc
蜓	tycp
厛	tycq
蝏	tycs
汀	tye
涏	tyeq
渟	tyes
濎	tyet
聽	tyfq
邒	tyfs
綎	tyft
聤	tyfu
聴	tyfv
聼	tyfw
庭	tyg
廳	tygq
庁	tygs
庍	tygt
鞓	tygu
廰	tygv
烃	tyh
烴	tyhq
烶	tyhs
梃	tyi
桯	tyiq
楟	tyis
榳	tyit
铤	tyj
鋌	tyjq
筳	tykq
耓	tylq
脡	tyls
閮	tymq
婷	tyn
娗	tynq
听	tyo
霆	tyr
嵉	tysq
鼮	tyss
亭	tyt
圢	tytq
甼	tyts
莛	tyu
葶	tyup
停	tyv
侹	tyvq
侱	tyvs
珽	tywq
忊	tyxq
廷	tyy
颋	tyyq
誔	tyys
頲	tyyt
諪	tyyu
艇	tyz
疼	tzb
痋	tzbq
螣	tzcq
漛	tzeq
縢	tzfq
鼟	tzgq
熥	tzhq
幐	tzjq
籐	tzkq
籘	tzks
腾	tzl
滕	tzlp
膯	tzlq
騰	tzmq
駦	tzms
驣	tzmt
霯	tzrq
藤	tzu
虅	tzuq
儯	tzvq
誊	tzy
謄	tzyq
鰧	tzys
邆	tzzq
扎	uaa
揸	uaap
摣	uaaq
抯	uaas
拃	uaat
挓	uaau
搾	uaav
痄	uab
齄	uabp
齇	uabq
宱	uabs
轧	uac
蚱	uacp
軋	uacq
蠟	uacs
厏	uact
蚻	uacu
劄	uadq
奓	uads
剳	uadt
渣	uae
溠	uaeq
潳	uaes
紮	uafq
紥	uafs
炸	uah
灹	uahq
煠	uahs
栅	uai
榨	uaic
柞	uaid
楂	uaie
札	uaip
柵	uaiq
柤	uais
査	uait
樝	uaiu
铡	uaj
鍘	uajq
觰	uajs
箚	uakq
耫	ualq
眨	uam
闸	uamp
閘	uamq
咋	uao
吒	uaoc
咤	uaod
哳	uaoe
喳	uaop
啑	uaoq
喥	uaos
乍	uap
砟	uapp
牐	uapq
皶	uaps
皻	uapt
醡	uaqq
霅	uarq
飵	uasq
苲	uauq
偧	uavq
诈	uay
詐	uayq
鲊	uays
鲝	uayt
諎	uayu
鮓	uayv
鮺	uayw
譇	uayx
譗	uayy
找	uca
招	ucap
兆	uce
沼	ucep
罀	ucfq
旐	ucfs
照	uch
炤	uchq
燳	uchs
棹	uci
枛	uciq
櫂	ucis
钊	ucj
釗	ucjq
釽	ucjs
鉊	ucjt
鍣	ucju
笊	uck
箌	uckq
朝	ucl
着	ucm
鼌	ucmq
駋	ucms
瞾	ucmt
鼂	ucmu
妱	ucnq
鳭	ucns
召	uco
啅	ucoq
皽	ucpq
狣	ucqq
昭	ucr
曌	ucrq
罩	ucs
巶	ucsq
羄	ucss
垗	uctq
菬	ucuq
佋	ucvq
瑵	ucwq
肇	ucy
诏	ucyp
詔	ucyq
肁	ucys
肈	ucyt
鮡	ucyu
謿	ucyv
赵	ucz
爪	uczp
趙	uczq
爫	uczs
摘	uda
擇	udaq
択	udas
抧	udat
捚	udau
擿	udav
寨	udb
瘵	udbc
宅	udbp
責	udbq
厇	udcq
厏	udcs
亝	udeq
榸	udiq
檡	udis
鉙	udjq
粂	udmq
嚌	udoq
砦	udp
齋	udqq
债	udv
側	udvq
債	udvs
斋	udw
斎	udwq
窄	udx
翟	udy
夈	udzq
折	uea
摺	ueap
扸	ueaq
搩	ueas
辙	uec
辄	uecc
蜇	uecd
赭	uece
螫	uecf
蛰	uecp
蟄	uecq
轍	uecs
輒	uect
厇	uecu
虴	uecv
輙	uecw
蟅	uecx
歽	uedq
浙	uee
淛	ueeq
聑	uefq
柘	uei
杔	ueiq
棏	ueis
樜	ueit
锗	uej
鍺	uejq
銸	uejs
褶	uek
袩	uekq
襵	ueks
者	uel
着	uem
籷	uemq
粍	uems
馲	uemt
鹧	uen
鷓	uenq
嫬	uens
哲	ueo
啠	ueoq
喆	ueos
嗻	ueot
嚞	ueou
乇	uep
磔	uepp
矺	uepq
砓	ueps
晢	uerq
晣	uers
埑	uetq
蔗	ueu
乽	uevq
悊	uexq
慹	uexs
谪	uey
謫	ueyq
詟	ueys
謺	ueyt
鮿	ueyu
讁	ueyv
讋	ueyw
这	uez
遮	uezp
這	uezq
踷	uezs
掫	ufaq
宙	ufb
疛	ufbq
赒	ufbs
賙	ufbt
州	ufc
轴	ufcp
軸	ufcq
辀	ufcs
徟	ufct
輈	ufcu
輖	ufcv
洲	ufe
淍	ufeq
纣	uff
繇	uffc
绉	uffp
紂	uffq
縐	uffs
郮	ufft
炿	ufhq
烐	ufhs
椆	ufiq
帚	ufj
銂	ufjq
籀	ufk
箒	ufkq
籕	ufks
籒	ufkt
肘	ufl
胄	uflp
胕	uflq
骤	ufm
粥	ufmp
驟	ufmq
粙	ufms
睭	ufmt
駎	ufmu
駲	ufmv
盩	ufmw
騆	ufmx
妯	ufn
鸼	ufnq
婤	ufns
鵃	ufnt
周	ufo
啁	ufoc
咒	ufop
呪	ufoq
咮	ufos
喌	ufot
噣	ufou
嚋	ufov
皱	ufp
碡	ufpp
皺	ufpq
酎	ufq
昼	ufr
晝	ufrq
晭	ufrs
霌	ufrt
矪	ufsq
冑	uftq
荮	ufu
葤	ufuq
菷	ufus
薵	ufut
伷	ufvq
侜	ufvs
僽	ufvt
珘	ufwq
甃	ufws
诌	ufy
調	ufyq
謅	ufys
诪	ufyt
詋	ufyu
翢	ufyv
鯞	ufyw
譸	ufyx
舟	ufz
週	ufzq
振	uga
抮	ugaq
挋	ugas
揕	ugat
搸	ugau
贞	ugb
赈	ugbc
疹	ugbp
貞	ugbq
賑	ugbs
寊	ugbt
鬒	ugbu
轸	ugc
軫	ugcq
轃	ugcs
辴	ugct
斟	ugd
殝	ugdq
浈	uge
湞	ugeq
潧	uges
澵	uget
阵	ugf
缜	ugfp
陣	ugfq
縝	ugfs
纼	ugft
紖	ugfu
聄	ugfv
紾	ugfw
絼	ugfx
縥	ugfy
弫	uggq
稹	ugh
黰	ughq
枕	ugi
椹	ugic
榛	ugid
桢	ugip
楨	ugiq
枮	ugis
栚	ugit
桭	ugiu
槙	ugiv
榐	ugiw
樼	ugix
镇	ugj
帧	ugjc
鎭	ugjo
针	ugjp
針	ugjq
幀	ugjs
鎮	ugjt
帪	ugju
覙	ugjv
鉁	ugjw
鋴	ugjx
錱	ugjy
鍼	ugjz
箴	ugk
袗	ugkq
裖	ugks
籈	ugkt
胗	ugl
朕	uglp
竧	uglq
眕	ugmq
眞	ugms
眹	ugmt
駗	ugmu
鸩	ugn
鴆	ugnq
姫	ugns
嫃	ugnt
砧	ugp
屒	ugpq
碪	ugps
酙	ugqq
獉	ugqs
震	ugr
昣	ugrq
真	ugs
祯	ugsp
禎	ugsq
禛	ugss
圳	ugt
畛	ugtp
甽	ugtq
塦	ugts
蓁	ugu
萙	uguq
葴	ugus
蒖	ugut
薽	uguu
侦	ugv
偵	ugvq
侲	ugvs
珍	ugw
甄	ugwp
珎	ugwq
瑧	ugws
瑱	ugwt
诊	ugy
診	ugyq
誫	ugys
鱵	ugyt
臻	ugz
遉	ugzq
掌	uha
扙	uhaq
账	uhb
瘴	uhbp
長	uhbq
賬	uhbs
痮	uhbt
瘬	uhbu
长	uhc
蟑	uhcp
涨	uhe
漳	uhep
漲	uheq
兏	uhes
涱	uhet
障	uhf
鄣	uhfp
张	uhg
張	uhgq
弡	uhgs
鞝	uhgt
丈	uhh
杖	uhi
樟	uhip
帐	uhj
幛	uhjp
帳	uhjq
幥	uhjs
鏱	uhjt
章	uhl
胀	uhlp
脹	uhlq
麞	uhls
粀	uhmq
粻	uhms
瞕	uhmt
騿	uhmu
嫜	uhn
礃	uhpq
獐	uhq
暲	uhrq
彰	uhs
嶂	uhsp
餦	uhsq
墇	uhtq
蔁	uhuq
仗	uhv
仉	uhvp
仧	uhvq
傽	uhvs
璋	uhw
慞	uhxq
鱆	uhyq
遧	uhzq
指	uia
掷	uiac
挚	uiad
摭	uiae
擿	uial
擳	uiam
摨	uian
摕	uiao
执	uiap
摯	uiaq
擲	uias
扺	uiat
扻	uiau
抧	uiav
挃	uiaw
捗	uiax
搘	uiay
搱	uiaz
质	uib
贽	uibc
痣	uibd
痔	uibp
質	uibq
贄	uibs
疻	uibt
疷	uibu
貭	uibv
痓	uibw
寘	uibx
瘈	uiby
蜘	uic
轾	uicc
蛭	uicd
轵	uicp
軹	uicq
輊	uics
厔	uict
蚔	uicu
徏	uicv
徝	uicw
徴	uicx
螲	uicy
蟙	uicz
之	uid
殖	uidc
制	uidp
剬	uidq
劕	uids
治	uie
汁	uiec
瀄	uiek
潪	uiel
漐	uiem
潌	uien
滍	uieo
滞	uiep
滯	uieq
汥	uies
沚	uiet
汦	uieu
泜	uiev
洔	uiew
洷	uiex
淽	uiey
淔	uiez
职	uif
纸	uifc
郅	uifd
陟	uife
絷	uiff
豒	uifi
豑	uifj
緻	uifk
隲	uifl
旘	uifm
聜	uifn
絺	uifo
织	uifp
紙	uifq
職	uifs
織	uift
縶	uifu
酈	uifv
阯	uifw
聀	uifx
紩	uify
綕	uifz
庤	uigq
庢	uigs
戠	uigt
瓡	uigu
廌	uigv
稚	uih
炙	uihc
秩	uihp
秇	uihq
秓	uihs
秖	uiht
秲	uihu
秷	uihv
稙	uihw
稺	uihx
熫	uihy
穉	uihz
枝	uii
栉	uiic
枳	uiid
栀	uiie
桎	uiif
櫍	uiim
樴	uiin
槯	uiio
植	uiip
梔	uiiq
櫛	uiis
杫	uiit
柣	uiiu
栺	uiiv
梽	uiiw
楖	uiix
椥	uiiy
榰	uiiz
帜	uij
帙	uijc
觯	uijd
鑕	uijk
鋕	uijl
銴	uijm
銍	uijn
覟	uijo
卮	uijp
幟	uijq
觶	uijs
凪	uijt
帋	uiju
斦	uijv
釞	uijw
铚	uijx
觗	uijy
锧	uijz
衼	uikq
衹	uiks
袟	uikt
袠	uiku
筫	uikv
製	uikw
襧	uikx
肢	uil
胝	uilc
膣	uild
脂	uilp
劧	uilq
胑	uils
膱	uilt
骘	uim
騭	uimq
眰	uims
馶	uimt
馽	uimu
駤	uimv
驇	uimw
騺	uimx
鼅	uimy
鸷	uin
鶨	uino
鷙	uinq
妷	uins
姪	uint
娡	uinu
犆	uinv
鳷	uinw
嬂	uinx
鴙	uiny
鴲	uinz
只	uio
吱	uiop
呮	uioq
咫	uip
砋	uipq
礩	uips
酯	uiq
狾	uiqq
猘	uiqs
智	uir
旨	uirp
晊	uirq
知	uis
置	uisc
峙	uisd
祉	uise
彘	uisf
直	uisp
巵	uisq
祇	uiss
祑	uist
祬	uisu
崻	uisv
禃	uisw
禔	uisx
軄	uisy
址	uit
埴	uitp
執	uitq
坁	uits
坧	uitt
垁	uitu
畤	uitv
墆	uitw
墌	uitx
芝	uiu
芷	uiup
芖	uiuq
茋	uius
茝	uiut
菭	uiuu
藢	uiuv
蘵	uiuw
值	uiv
侄	uivp
伿	uivq
俧	uivs
値	uivt
倁	uivu
偫	uivv
乿	uivw
傂	uivx
儨	uivy
致	uiw
璏	uiwq
瓆	uiws
志	uix
忮	uixc
窒	uixp
恉	uixq
慹	uixs
憄	uixt
懥	uixu
懫	uixv
黹	uiy
誌	uiyq
識	uiys
訨	uiyt
翐	uiyu
鯯	uiyv
至	uiz
止	uizc
趾	uizd
豸	uize
跖	uizf
雉	uizg
踬	uizh
踯	uizi
蹢	uizm
蹠	uizn
疐	uizo
支	uizp
雙	uizq
躑	uizs
躓	uizt
迣	uizu
歭	uizv
隻	uizw
臷	uizx
臸	uizy
跱	uizz
准	ukb
宒	ukbq
凖	ukbs
衠	ukcq
準	ukeq
綧	ukfq
屯	ukh
稕	ukhq
肫	ukl
啍	ukoq
旽	ukrq
圫	uktq
埻	ukts
窀	ukx
忳	ukxq
谆	uky
諄	ukyq
訰	ukys
迍	ukzq
搌	ula
占	ulb
辗	ulc
輾	ulcq
蛅	ulcs
輚	ulct
轏	ulcu
沾	ule
湛	ulep
绽	ulf
旃	ulfp
綻	ulfq
飐	ulfs
颭	ulft
旜	ulfu
战	ulg
戰	ulgq
戦	ulgs
魙	ulgt
虦	ulhq
虥	ulhs
黵	ulht
栈	uli
棧	uliq
枬	ulis
桟	ulit
栴	uliu
榐	uliv
橏	uliw
欃	ulix
斩	ulj
斬	uljq
覱	uljs
襢	ulkq
站	ull
粘	ulm
瞻	ulmc
毡	ulmd
盏	ulmp
盞	ulmq
氈	ulms
驏	ulmt
閚	ulmu
氊	ulmv
驙	ulmw
鳽	ulnq
嫸	ulns
鹯	ulnt
鸇	ulnu
噡	uloq
展	ulp
碊	ulpq
皽	ulps
醆	ulqq
霑	ulrq
崭	uls
嶄	ulsq
飦	ulss
嵁	ulst
嶃	ulsu
嶘	ulsv
嶦	ulsw
饘	ulsx
蘸	ulu
菚	uluq
薝	ulus
佔	ulvq
偡	ulvs
僝	ulvt
琖	ulwq
怗	ulxq
惉	ulxs
詹	uly
谵	ulyp
顫	ulyq
譫	ulys
詀	ulyt
譧	ulyu
鳣	ulyv
鱣	ulyw
讝	ulyx
趈	ulzq
邅	ulzs
捉	uoa
擢	uoac
拙	uoap
捔	uoaq
擆	uoas
撯	uoat
彴	uocq
蠗	uocs
蠿	uoct
剢	uodq
劅	uods
浊	uoe
涿	uoec
濯	uoed
浞	uoep
濁	uoeq
汋	uoes
灂	uoet
繳	uofq
聉	uofs
灼	uoh
炪	uohq
烵	uohs
燋	uoht
穛	uohu
穱	uohv
桌	uoi
梲	uoiq
棁	uois
椓	uoit
棳	uoiu
槕	uoiv
櫡	uoiw
镯	uoj
鐲	uojq
斱	uojs
斮	uojt
斲	uoju
鋜	uojv
斵	uojw
鐯	uojx
篧	uokq
籗	uoks
籱	uokt
着	uom
妰	uonq
娺	uons
鵫	uont
鷟	uonu
啄	uoo
啅	uooq
噣	uoos
斫	uop
硺	uopq
酌	uoq
犳	uoqq
晫	uorq
卓	uos
禚	uosp
罬	uosq
圴	uotq
墌	uots
茁	uou
蓔	uouq
藋	uous
倬	uov
琢	uow
琸	uowq
斀	uows
窧	uoxq
窡	uoxs
诼	uoy
諑	uoyq
叕	uoys
丵	uoyt
諁	uoyu
謶	uoyv
這	upzq
撞	uqa
湷	uqeq
漴	uqes
庄	uqg
庒	uqgq
焋	uqhq
桩	uqi
樁	uqiq
梉	uqis
幢	uqj
装	uqk
裝	uqkq
粧	uqmq
糚	uqms
妆	uqn
妝	uqnq
娤	uqns
壮	uqp
状	uqq
狀	uqqq
壯	uqsq
壵	uqss
莊	uquq
荘	uqus
僮	uqv
戇	uqxq
戅	uqxs
撰	ura
赚	urb
賺	urbq
转	urc
專	urcq
轉	urcs
専	urct
転	urcu
蟤	urcv
剸	urdq
耑	ureq
漙	ures
鄟	urfq
縳	urfs
专	urh
灷	urhq
篆	urk
篹	urkq
篿	urks
襈	urkt
簨	urku
籑	urkv
腞	urlq
膞	urls
竱	urlt
嫥	urnq
啭	uro
囀	uroq
砖	urp
磚	urpq
磗	urps
馔	urs
饌	ursq
叀	urss
堟	urtq
塼	urts
蒃	uruq
传	urv
傳	urvq
僝	urvs
僎	urvt
瑑	urwq
瑼	urws
甎	urwt
恮	urxq
颛	ury
顓	uryq
諯	urys
譔	uryt
鱄	uryu
孨	urzq
瘇	usbq
螽	usc
彸	uscq
蚛	uscs
蜙	usct
徸	uscu
螤	uscv
刣	usdq
汷	useq
泈	uses
终	usf
終	usfq
緟	usfs
种	ush
種	ushq
炂	ushs
煄	usht
穜	ushu
柊	usiq
钟	usj
锺	usjp
鐘	usjq
鍾	usjs
鈡	usjt
幒	usju
銿	usjv
衷	usk
衶	uskq
衳	usks
筗	uskt
籦	usku
中	usl
肿	uslp
腫	uslq
盅	usm
冢	usmp
眾	usmq
妕	usnq
妐	usns
媑	usnt
鴤	usnu
喠	usoq
重	usp
狆	usqq
祌	ussq
鼨	usss
堹	ustq
塚	usts
茽	usuq
蔠	usus
众	usv
仲	usvp
伀	usvq
偅	usvs
斔	uswq
忠	usx
忪	usxp
衆	usxq
尰	usyq
諥	usys
舯	usz
踵	uszp
歱	uszq
蹱	uszs
拄	uua
拀	uuaq
贮	uub
瘃	uubc
疰	uubp
貯	uubq
寧	uubs
宔	uubt
癷	uubu
蛛	uuc
蠾	uuco
蛀	uucp
術	uucq
虲	uucs
尌	uuct
軴	uucu
徚	uucv
蝫	uucw
蝊	uucx
蠋	uucy
蠩	uucz
主	uud
丶	uudp
劚	uudq
注	uue
渚	uuec
潴	uued
洙	uuep
瀦	uueq
濐	uues
灟	uuet
邾	uuf
纻	uufq
聁	uufs
陼	uuft
紸	uufu
紵	uufv
絑	uufw
庻	uugq
煮	uuh
炷	uuhc
爥	uuho
烛	uuhp
燭	uuhq
炢	uuhs
烪	uuht
秼	uuhu
焑	uuhv
煑	uuhw
稥	uuhx
燞	uuhy
燝	uuhz
朱	uui
株	uuic
杼	uuid
槠	uuie
橥	uuif
柱	uuip
櫧	uuiq
櫫	uuis
朮	uuit
柷	uuiu
樦	uuiv
櫡	uuiw
欘	uuix
铸	uuj
铢	uujp
鑄	uujq
銖	uujs
帾	uujt
鉒	uuju
鋳	uujv
鍂	uujw
鐢	uujx
斸	uujy
钃	uujz
竹	uuk
竺	uukc
箸	uukd
筑	uukp
築	uukq
笁	uuks
笜	uukt
袾	uuku
袰	uukv
筯	uukw
篫	uukx
篴	uuky
簗	uukz
助	uul
麈	uulp
劯	uulq
朑	uuls
竚	uult
麆	uulu
驻	uum
闧	uumo
瞩	uump
駐	uumq
矚	uums
毜	uumt
毝	uumu
眝	uumv
毮	uumw
馵	uumx
駯	uumy
鼄	uumz
鴸	uunq
鸀	uuns
孎	uunt
嘱	uuo
囑	uuoq
嗻	uuos
属	uup
屬	uupq
殶	uups
砫	uupt
屗	uupu
硃	uupv
磩	uupw
猪	uuq
曢	uurq
霻	uurs
曯	uurt
祝	uus
豬	uusq
壴	uuss
罜	uust
祩	uusu
嵀	uusv
飳	uusw
坾	uutq
墸	uuts
著	uuu
茱	uuuc
苎	uuup
苧	uuuq
芧	uuus
茿	uuut
莇	uuuu
蒊	uuuv
蓫	uuuw
蕏	uuux
薴	uuuy
藸	uuuz
住	uuv
侏	uuvc
伫	uuvp
佇	uuvq
乼	uuvs
珠	uuw
敱	uuwq
敳	uuws
斀	uuwt
窋	uuxq
诸	uuy
翥	uuyc
诛	uuyp
註	uuyq
誅	uuys
諸	uuyt
羜	uuyu
詝	uuyv
鮢	uuyw
鯺	uuyx
鱁	uuyy
逐	uuz
躅	uuzc
舳	uuzp
迬	uuzq
逫	uuzs
跓	uuzt
跦	uuzu
艈	uuzv
赘	uvb
贅	uvbq
奞	uvdq
沝	uveq
缀	uvf
缒	uvfp
隊	uvfq
綴	uvfs
縋	uvft
椎	uvi
锥	uvj
錐	uvjq
錣	uvjs
鑆	uvjt
笍	uvkq
腏	uvlq
膇	uvls
骓	uvm
騅	uvmq
娷	uvnq
鵻	uvns
硾	uvpq
礈	uvps
醊	uvqq
坠	uvt
墜	uvtq
畷	uvts
萑	uvu
甀	uvwq
惴	uvx
諈	uvyq
追	uvz
隹	uvzp
抓	uwa
挝	uwap
撾	uwaq
髽	uwbq
蛀	uwc
檛	uwiq
簻	uwkq
膼	uwlq
瞩	uwm
爪	uwz
爫	uwzq
拽	uya
轉	uycq
睉	uymq
跩	uyzq
挣	uza
拯	uzap
掙	uzaq
抍	uzas
掟	uzat
揁	uzau
撜	uzav
症	uzb
癥	uzbq
鬇	uzbs
征	uzc
徵	uzcp
徎	uzcq
徰	uzcs
徴	uzct
争	uzd
氶	uzeq
郑	uzf
鄭	uzfq
糽	uzfs
聇	uzft
綪	uzfu
炡	uzhq
烝	uzhs
钲	uzj
铮	uzjp
鉦	uzjq
錚	uzjs
凧	uzjt
幁	uzju
鏳	uzjv
筝	uzk
箏	uzkq
篜	uzks
脀	uzlq
睁	uzm
睜	uzmq
眐	uzms
姃	uznq
媜	uzns
鴊	uznt
狰	uzq
猙	uzqq
靕	uzqs
晸	uzrq
峥	uzs
崢	uzsq
崝	uzss
埩	uztq
埥	uzts
塣	uztt
蒸	uzu
佂	uzvq
政	uzw
整	uzwp
怔	uzx
愸	uzxq
憕	uzxs
证	uzy
诤	uzyp
證	uzyq
諍	uzys
鯖	uzyt
証	uzyu
正	uzz
爭	uzzq
踭	uzzs
插	vaa
搽	vaap
扱	vaaq
扠	vaas
挿	vaat
捈	vaau
揷	vaav
摖	vaaw
察	vab
刹	vad
剎	vadq
汊	vae
紁	vafq
差	vag
靫	vagq
秅	vahq
查	vai
楂	vaic
槎	vaid
檫	vaie
杈	vaip
査	vaiq
梌	vais
锸	vaj
镲	vajp
鍤	vajq
鑔	vajs
臿	vajt
銟	vaju
鎈	vajv
衩	vak
姹	van
奼	vanq
喳	vao
嚓	vaop
嗏	vaoq
碴	vap
猹	vaq
岔	vas
馇	vasp
餷	vasq
嵖	vass
垞	vatq
疀	vats
茶	vau
茬	vaup
芆	vauq
仛	vavq
侘	vavs
偛	vavt
叉	vay
诧	vayp
詫	vayq
詧	vays
艖	vazq
蹅	vazs
抄	vca
摷	vcaq
巢	vcc
巣	vccq
轈	vccs
剿	vcd
劋	vcdq
潮	vce
漅	vceq
绰	vcf
綽	vcfq
鄛	vcfs
弨	vcgq
炒	vch
焯	vchp
焣	vchq
煼	vchs
槱	vciq
樔	vcis
钞	vcj
鈔	vcjq
觘	vcjs
朝	vcl
耖	vclp
勦	vclq
眧	vcmq
粆	vcms
鼌	vcmt
麨	vcmu
鼂	vcmv
吵	vco
嘲	vcop
牊	vcpq
欩	vcqq
晁	vcr
禉	vcsq
罺	vcss
巐	vcst
仦	vcvq
仯	vcvs
怊	vcx
窲	vcxq
窼	vcxs
訬	vcyq
謿	vcys
超	vcz
拆	vda
瘥	vdb
虿	vdc
蠆	vdcq
差	vdg
柴	vdi
钗	vdj
釵	vdjq
袃	vdkq
肞	vdlq
喍	vdoq
囆	vdos
犲	vdqq
祡	vdsq
芆	vduq
茝	vdus
侪	vdv
儕	vdvq
訍	vdyq
豺	vdz
撤	vea
掣	veac
扯	veap
揊	veaq
撦	veas
摰	veat
车	vec
彻	vecp
車	vecq
徹	vecs
蛼	vect
奲	vedq
澈	vee
聅	vefq
烢	vehq
烲	vehs
焎	veht
爡	vehu
屮	vel
勶	velq
瞮	vemq
呫	veoq
唓	veos
砗	vep
硨	vepq
硩	veps
坼	vet
莗	veuq
伡	vevq
俥	vevs
偖	vevt
頙	veyq
迠	vezq
抽	vfa
掫	vfaq
搊	vfas
瘳	vfb
皗	vfbq
殠	vfdq
绸	vff
綢	vffq
紬	vffs
絒	vfft
魗	vfgq
稠	vfh
丒	vfhq
燽	vfhs
杽	vfiq
杻	vfis
栦	vfit
梼	vfiu
椆	vfiv
檮	vfiw
帱	vfj
幬	vfjq
筹	vfk
籌	vfkq
裯	vfks
篘	vfkt
瞅	vfm
盩	vfmq
矁	vfms
牰	vfnq
婤	vfns
嬦	vfnt
犨	vfnu
犫	vfnv
吜	vfoq
嚋	vfos
酬	vfq
醜	vfqq
酧	vfqs
醔	vfqt
醻	vfqu
畴	vft
疇	vftq
畤	vfts
菗	vfuq
薵	vfus
仇	vfv
俦	vfvc
丑	vfvp
儔	vfvq
偢	vfvs
愁	vfx
惆	vfxp
怞	vfxq
懤	vfxs
讎	vfyq
诪	vfys
詶	vfyt
鮘	vfyu
譸	vfyv
讐	vfyw
臭	vfz
雠	vfzc
踌	vfzp
躊	vfzq
遚	vfzs
臰	vfzt
跾	vfzu
雔	vfzv
雦	vfzw
抻	vga
捵	vgaq
宸	vgb
疢	vgbq
瘎	vgbs
賝	vgbt
瘨	vgbu
贂	vgbv
臣	vgc
龀	vgcc
辰	vgcp
齔	vgcq
軙	vgcs
齓	vgct
螴	vgcu
沉	vge
沈	vgep
陈	vgf
郴	vgfp
陳	vgfq
綝	vgfs
称	vgh
稱	vghq
烥	vghs
煁	vght
穪	vghu
榇	vgi
櫬	vgiq
栕	vgis
桭	vgit
梣	vgiu
棽	vgiv
樄	vgiw
鈂	vgjq
鍖	vgjs
衬	vgk
襯	vgkq
麎	vglq
瞋	vgmq
鷐	vgnq
嗔	vgo
嚫	vgoq
碜	vgp
磣	vgpq
硶	vgps
醦	vgqq
晨	vgr
霃	vgrq
曟	vgrs
塵	vgtq
墋	vgts
茞	vguq
莀	vgus
莐	vgut
蔯	vguu
薼	vguv
傖	vgvq
偁	vgvs
儭	vgvt
琛	vgw
敐	vgwq
敶	vgws
尘	vgx
忱	vgxp
愖	vgxq
夦	vgxs
谌	vgy
谶	vgyp
諶	vgyq
讖	vgys
訦	vgyt
諃	vgyu
謓	vgyv
趁	vgz
迧	vgzq
爯	vgzs
趻	vgzt
趂	vgzu
跈	vgzv
踸	vgzw
鬯	vhb
長	vhbq
镸	vhbs
长	vhc
徜	vhcc
厂	vhcp
厰	vhcq
蟐	vhcs
兏	vheq
淐	vhes
廠	vhgq
甞	vhgs
鼚	vhgt
焻	vhhq
椙	vhiq
常	vhj
锠	vhjq
鋹	vhjs
錩	vhjt
裳	vhk
裮	vhkq
肠	vhl
畅	vhlp
腸	vhlq
膓	vhls
阊	vhm
氅	vhmp
閶	vhmq
闛	vhms
娼	vhn
嫦	vhnp
唱	vho
嘗	vhoq
嚐	vhos
猖	vhq
昌	vhr
昶	vhrp
暢	vhrq
场	vht
場	vhtq
塲	vhts
畼	vhtt
苌	vhu
菖	vhup
萇	vhuq
偿	vhv
伥	vhvc
倡	vhvp
償	vhvq
倀	vhvs
仧	vhvt
仩	vhvu
僘	vhvv
敞	vhw
玚	vhwq
瓺	vhws
琩	vhwt
瑒	vhwu
瑺	vhwv
韔	vhww
尝	vhx
惝	vhxc
怅	vhxp
悵	vhxq
鲳	vhy
鯧	vhyq
誯	vhys
鲿	vhyt
鱨	vhyu
持	via
扡	viaq
抶	vias
拸	viat
捇	viau
摛	viav
攡	viaw
痴	vib
瘛	vibc
匙	vibp
癡	vibq
貾	vibs
痸	vibt
瘈	vibu
赤	vic
彳	vicc
蚩	vicd
螭	vice
齿	vicp
齒	vicq
蚇	vics
蚳	vict
徲	vicu
齝	vicv
豉	vid
奓	vidq
殦	vids
池	vie
沶	vieq
湁	vies
漦	viet
耻	vif
絺	vifq
弛	vig
魑	vigp
炽	vih
熾	vihq
灻	vihs
烾	viht
黐	vihu
杘	viiq
柅	viis
樆	viit
斥	vij
卶	vijq
鉓	vijs
銐	vijt
鉹	viju
鍉	vijv
笞	vik
篪	vikc
褫	vikp
竾	vikq
袳	viks
筂	vikt
袲	viku
裭	vikv
箎	vikw
箈	vikx
肔	vilq
勅	vils
胣	vilt
勑	vilu
胵	vilv
耛	vilw
腟	vilx
驰	vim
眵	vimp
馳	vimq
粚	vims
瞝	vimt
麶	vimu
鸱	vin
媸	vinp
鴟	vinq
妛	vins
鵄	vint
鶒	vinu
鶗	vinv
鶙	vinw
鷘	vinx
吃	vio
哧	vioc
啻	viod
嗤	vioe
叱	viop
叺	vioq
呎	vios
喫	viot
噄	viou
噭	viov
尺	vip
硳	vipq
狋	viqq
欼	viqs
雴	virq
饬	vis
飭	visq
彨	viss
彲	vist
墀	vit
垑	vitq
茌	viu
荎	viuq
菭	vius
侈	viv
傺	vivp
伬	vivq
佁	vivs
侙	vivt
俿	vivu
敕	viw
瓻	viwq
恥	vixq
恜	vixs
憏	vixt
慗	vixu
慸	vixv
懘	vixw
翅	viy
翄	viyq
訵	viys
誃	viyt
翤	viyu
誺	viyv
翨	viyw
謘	viyx
迟	viz
邌	vizn
趩	vizo
踟	vizp
遲	vizq
迡	vizs
歭	vizt
赿	vizu
歯	vizv
遅	vizw
跢	vizx
遟	vizy
遫	vizz
賰	vkbq
蠢	vkc
蝽	vkcp
輴	vkcq
淳	vke
浱	vkeq
湻	vkes
滣	vket
漘	vkeu
纯	vkf
純	vkfq
陙	vkfs
椿	vki
杶	vkiq
槆	vkis
橁	vkit
櫄	vkiu
錞	vkjq
箺	vkkq
脣	vklq
膞	vkls
睶	vkmq
鹑	vkn
鶉	vknq
犉	vkns
媋	vknt
鶞	vknu
唇	vko
醇	vkq
醕	vkqq
春	vkr
旾	vkrq
暙	vkrs
堾	vktq
莼	vku
蒓	vkuq
芚	vkus
萅	vkut
萶	vkuu
蓴	vkuv
偆	vkvq
瑃	vkwq
惷	vkxq
鯙	vkyq
鰆	vkys
搀	vla
掺	vlap
摻	vlaq
攙	vlas
摲	vlat
摌	vlau
冁	vlb
毚	vlbq
蝉	vlc
蟾	vlcp
蟬	vlcq
螹	vlcs
刬	vldq
剗	vlds
剷	vldt
劖	vldu
潺	vle
澶	vlep
浐	vleq
湹	vles
滻	vlet
潹	vleu
瀍	vlev
瀺	vlew
灛	vlex
缠	vlf
纏	vlfq
斺	vlfs
緂	vlft
緾	vlfu
鄽	vlfv
繟	vlfw
酁	vlfx
繵	vlfy
纒	vlfz
廛	vlg
韂	vlgq
煘	vlhq
燀	vlhs
梴	vliq
棎	vlis
欃	vlit
铲	vlj
觇	vljp
鏟	vljq
覘	vljs
鋋	vljt
幝	vlju
鋓	vljv
幨	vljw
镵	vljx
鑱	vljy
裧	vlkq
簅	vlks
襜	vlkt
丳	vllq
阐	vlm
骣	vlmp
闡	vlmq
驏	vlms
閳	vlmt
婵	vln
嬋	vlnq
單	vloq
囅	vlos
啴	vlot
嘽	vlou
嚵	vlov
孱	vlp
羼	vlpp
硟	vlpq
磛	vlps
獑	vlqq
醦	vlqs
旵	vlrq
馋	vls
禅	vlsp
產	vlsq
嶄	vlss
饞	vlst
禪	vlsu
産	vlsv
嶃	vlsw
巉	vlsx
产	vlt
壥	vltq
蒇	vlu
蕆	vluq
苂	vlus
僝	vlvq
儃	vlvs
儳	vlvt
忏	vlx
懺	vlxq
懴	vlxs
颤	vly
谄	vlyc
谗	vlyp
顫	vlyq
讒	vlys
諂	vlyt
誗	vlyu
譂	vlyv
讇	vlyw
躔	vlz
辿	vlzq
艬	vlzs
拺	voaq
擉	voas
辍	voc
龊	vocp
輟	vocq
齪	vocs
涰	voeq
绰	vof
綽	vofq
繛	vofs
戳	vog
鏃	vojq
鋜	vojs
鑡	vojt
箹	vokq
娕	vonq
娖	vons
婼	vont
婥	vonu
孎	vonv
啜	voo
吷	vooq
哾	voos
嚽	voot
磭	vopq
酫	voqq
歠	voqs
餟	vosq
惙	voxq
辶	voz
踔	vozp
辵	vozq
逴	vozs
踀	vozt
趠	vozu
摐	vqaq
疮	vqb
瘡	vqbq
创	vqd
創	vqdq
刅	vqds
刱	vqdt
剏	vqdu
剙	vqdv
床	vqg
橦	vqiq
幢	vqj
朣	vqlq
闯	vqm
闖	vqmq
喠	vqoq
噇	vqos
牀	vqpq
牎	vqps
牕	vqpt
磢	vqpu
傸	vqvq
窗	vqx
怆	vqxp
愴	vqxq
窓	vqxs
窻	vqxt
賗	vrbq
川	vrc
巛	vrcp
輲	vrcq
剶	vrdq
汌	vreq
椽	vri
椯	vriq
钏	vrj
釧	vrjq
篅	vrkq
串	vrl
膞	vrlq
鶨	vrnq
喘	vro
氚	vrq
猭	vrqq
歂	vrqs
暷	vrrq
堾	vrtq
荈	vruq
传	vrv
傳	vrvq
僢	vrvs
玔	vrwq
圌	vrws
瑏	vrwt
穿	vrx
舛	vrxp
船	vrz
遄	vrzc
舡	vrzp
舩	vrzq
踳	vrzs
揰	vsaq
摏	vsas
冲	vsb
宠	vsbp
寵	vsbq
痋	vsbs
虫	vsc
蟲	vscq
蝩	vscs
衝	vsct
徸	vscu
沖	vseq
浺	vses
漴	vset
隀	vsfq
緟	vsfs
爞	vshq
舂	vsj
铳	vsjp
銃	vsjq
褈	vskq
嘃	vsoq
重	vsp
崇	vss
崈	vssq
罿	vsss
充	vst
埫	vstq
茺	vsu
珫	vswq
忡	vsx
憧	vsxp
憃	vsxq
翀	vsyq
艟	vsz
蹖	vszq
搐	vua
摴	vuaq
摢	vuas
厨	vuc
蜍	vucp
蟵	vucq
齣	vucs
齭	vuct
齼	vucu
初	vud
刍	vudp
滁	vue
泏	vueq
滀	vues
濋	vuet
除	vuf
绌	vufp
絀	vufq
鄐	vufs
廚	vugq
亍	vuh
黜	vuhp
處	vuhq
炪	vuhs
楚	vui
杵	vuic
楮	vuid
樗	vuie
橱	vuip
櫥	vuiq
椘	vuis
榋	vuit
橻	vuiu
檚	vuiv
櫉	vuiw
櫖	vuix
触	vuj
锄	vujp
鋤	vujq
觸	vujs
処	vujt
鉏	vuju
斶	vujv
幮	vujw
出	vuk
褚	vukp
篨	vukq
竌	vulq
竐	vuls
耝	vult
耡	vulu
臅	vulv
閦	vumq
媰	vunq
犓	vuns
鶵	vunt
嘼	vuoq
础	vup
礎	vupq
欪	vuqq
歜	vuqs
矗	vus
岀	vusq
豖	vuss
豠	vust
禇	vusu
畜	vut
埱	vutq
芻	vuuq
菆	vuus
蒢	vuut
蒭	vuuu
藸	vuuv
储	vuv
儲	vuvq
俶	vuvs
傗	vuvt
儊	vuvu
敊	vuwq
珿	vuws
璴	vuwt
怵	vux
憷	vuxp
慉	vuxq
諔	vuyq
处	vuz
躇	vuzc
蹰	vuzd
雏	vuzp
雛	vuzq
躕	vuzs
趎	vuzt
貙	vuzu
捶	vva
搥	vvaq
陲	vvf
炊	vvh
椎	vvi
槌	vvic
棰	vvip
桘	vviq
锤	vvj
錘	vvjq
鎚	vvjs
箠	vvkq
腄	vvlq
吹	vvo
垂	vvp
硾	vvpq
埀	vvtq
菙	vvuq
倕	vvvq
圌	vvwq
惙	vvxq
顀	vvyq
龡	vvys
欻	vwqq
揣	vya
搋	vyap
膪	vyl
膗	vylq
啜	vyo
嘬	vyop
欼	vyqq
踹	vyz
承	vza
撑	vzap
搶	vzaq
撐	vzas
挰	vzat
掁	vzau
揨	vzav
摚	vzaw
撜	vzax
凈	vzbq
宬	vzbs
蛏	vzc
蟶	vzcq
徎	vzcs
赪	vzct
赬	vzcu
澄	vze
氶	vzeq
泟	vzes
洆	vzet
浾	vzeu
浧	vzev
淨	vzew
溗	vzex
澂	vzey
瀓	vzez
阷	vzfq
郕	vzfs
絾	vzft
緽	vzfu
罉	vzfv
成	vzg
庱	vzgq
程	vzh
秤	vzhc
丞	vzhd
称	vzhp
稱	vzhq
穪	vzhs
橙	vzi
柽	vzic
枨	vzip
棖	vziq
檉	vzis
朾	vzit
棦	vziu
椉	vziv
橖	vziw
橕	vzix
檙	vziy
铖	vzj
铛	vzjp
鋮	vzjq
鐺	vzjs
鎗	vzjt
鏿	vzju
鐣	vzjv
裎	vzk
筬	vzkq
塍	vzl
脭	vzlq
骋	vzm
瞠	vzmp
騁	vzmq
睈	vzms
矃	vzmt
騬	vzmu
娍	vznq
呈	vzo
乘	vzp
乗	vzpq
碀	vzps
酲	vzq
靗	vzqq
晿	vzrq
峸	vzsq
饓	vzss
城	vzt
埕	vztp
埩	vztq
堘	vzts
塖	vztt
畻	vztu
荿	vzuq
侱	vzvq
偁	vzvs
僜	vzvt
珹	vzwq
琤	vzws
珵	vzwt
惩	vzx
懲	vzxq
悜	vzxs
窚	vzxt
憆	vzxu
憕	vzxv
竀	vzxw
诚	vzy
誠	vzyq
牚	vzys
頳	vzyt
鯎	vzyu
逞	vzz
爯	vzzq
挖	waa
搲	waaq
攨	waas
蛙	wac
徍	wacq
洼	wae
溛	waeq
漥	waes
邷	wafq
聉	wafs
韈	wagq
帓	wajq
袜	wak
襪	wakq
腽	wal
膃	walq
劸	wals
鼃	wamq
娃	wan
娲	wanp
媧	wanq
婠	wans
哇	wao
咼	waoq
咓	waos
唲	waot
啘	waou
嗢	waov
嗗	waow
砙	wapq
屲	wasq
畖	watq
佤	wav
瓦	waw
瓾	wawq
韎	waws
韤	wawt
窪	waxq
穵	waxs
窊	waxt
窐	waxu
鮭	wayq
瀤	wdeq
竵	wdlq
咼	wdoq
喎	wdos
崴	wds
外	wdx
夞	wdxq
顡	wdyq
歪	wdz
抆	wgaq
揾	wgas
搵	wgat
瘟	wgb
瘒	wgbq
蚊	wgc
蚉	wgcq
辒	wgcs
輼	wgct
螡	wgcu
轀	wgcv
蟁	wgcw
刎	wgd
歾	wgdq
殟	wgds
温	wge
汶	wgep
溫	wgeq
渂	wges
纹	wgf
紊	wgfp
紋	wgfq
聞	wgfs
缊	wgft
絻	wgfu
緼	wgfv
縕	wgfw
繧	wgfx
鞰	wggq
稳	wgh
穩	wghq
炆	wghs
穏	wght
桽	wgiq
榅	wgis
榲	wgit
鎾	wgjq
肳	wglq
脗	wgls
问	wgm
阌	wgmc
闻	wgmp
閿	wgmq
駇	wgms
馼	wgmt
閺	wgmu
闅	wgmv
闦	wgmw
妏	wgnq
鳼	wgns
鴍	wgnt
吻	wgo
問	wgoq
呅	wgos
呡	wgot
雯	wgr
昷	wgrq
彣	wgsq
豱	wgss
鼤	wgst
饂	wgsu
塭	wgtq
芠	wguq
莬	wgus
蕰	wgut
伆	wgvq
文	wgw
璺	wgwc
攵	wgwp
韞	wgwq
珳	wgws
瑥	wgwt
忟	wgxq
忞	wgxs
魰	wgyq
鳁	wgys
顐	wgyt
鰛	wgyu
鰮	wgyv
夂	wgz
抂	whaq
往	whc
辋	whcp
輞	whcq
彺	whcs
徃	whct
徍	whcu
蚟	whcv
蛧	whcw
蝄	whcx
汪	whe
瀇	wheq
網	whfq
魍	whg
枉	whi
棢	whiq
望	whl
朚	whlq
朢	whls
盳	whmq
妄	whn
旺	whr
兦	whrq
暀	whrs
罒	whsq
亡	wht
罔	whtc
网	whtp
罓	whtq
莣	whuq
菵	whus
亾	whvq
仼	whvs
王	whw
忘	whx
惘	whxp
忹	whxq
尣	whyq
尪	whys
尫	whyt
尩	whyu
誷	whyv
迋	whzq
迬	whzs
挽	wla
抏	wlaq
捖	wlas
捥	wlat
掔	wlau
完	wlb
皖	wlbc
宛	wlbp
貦	wlbq
贃	wlbs
贎	wlbt
蜿	wlc
蚖	wlcq
輓	wlcs
輐	wlct
蟃	wlcu
豌	wld
剜	wldp
刓	wldq
湾	wle
灣	wleq
汍	wles
涴	wlet
澫	wleu
潫	wlev
纨	wlf
绾	wlfp
紈	wlfq
綰	wlfs
絻	wlft
綄	wlfu
綩	wlfv
弯	wlg
彎	wlgq
万	wlh
烷	wlhp
杤	wliq
杬	wlis
梚	wlit
椀	wliu
槾	wliv
帵	wljq
鋄	wljs
鋔	wljt
錽	wlju
鋺	wljv
鎫	wljw
笂	wlkq
腕	wll
脘	wllp
脕	wllq
毌	wlmq
盌	wlms
睕	wlmt
瞣	wlmu
婉	wln
妧	wlnq
婠	wlns
唍	wloq
碗	wlp
丸	wlpp
晚	wlr
晥	wlrq
晩	wlrs
晼	wlrt
卐	wlsq
卍	wlss
岏	wlst
畹	wlt
埦	wltq
塆	wlts
壪	wltt
蔓	wlu
莞	wluc
菀	wlud
芄	wlup
萬	wluq
莬	wlus
萖	wlut
薍	wluu
乛	wlvq
倇	wlvs
玩	wlw
琬	wlwp
琓	wlwq
惋	wlx
夘	wlxq
夗	wlxs
忨	wlxt
惌	wlxu
顽	wly
頑	wlyq
翫	wlys
踠	wlzq
握	woa
挝	woap
撾	woaq
捰	woas
捾	woat
卧	wob
蜗	woc
龌	wocp
臥	wocq
蝸	wocs
齷	woct
斡	wod
沃	woe
渥	woec
涡	woep
渦	woeq
涹	woes
涴	woet
濄	woeu
濣	woev
緺	wofq
我	wog
焥	wohq
枂	woiq
楃	wois
幄	woj
肟	wol
臒	wolq
腛	wols
龏	wolt
瞃	womq
媼	wonq
婐	wons
婑	wont
媉	wonu
喔	woo
咼	wooq
唩	woos
硪	wop
猧	woqq
莴	wou
萵	wouq
薶	wous
倭	wov
仴	wovq
偓	wovs
瓁	wowq
窝	wox
窩	woxq
馧	woxs
踒	wozq
捤	wpaq
捼	wpas
揻	wpat
揋	wpau
撱	wpav
撝	wpaw
痿	wpb
痏	wpbq
寪	wpbs
癓	wpbt
癐	wpbu
微	wpc
軎	wpcc
轊	wpco
尉	wpcp
衛	wpcq
厃	wpcs
徫	wpct
蜲	wpcu
蜼	wpcv
蝛	wpcw
蝟	wpcx
衞	wpcy
螱	wpcz
为	wpd
危	wpdp
渭	wpe
沩	wpec
洧	wped
涠	wpee
瀢	wpen
濻	wpeo
潍	wpep
濰	wpeq
溈	wpes
潿	wpet
洈	wpeu
浘	wpev
渨	wpew
湋	wpex
溦	wpey
潙	wpez
维	wpf
隈	wpfc
隗	wpfd
纬	wpfp
維	wpfq
緯	wpfs
隇	wpft
鄬	wpfu
縅	wpfv
緭	wpfw
颹	wpfx
威	wpg
魏	wpgp
骩	wpgq
骪	wpgs
骫	wpgt
廆	wpgu
炜	wph
煨	wphp
為	wphq
煒	wphs
烓	wpht
煟	wphu
熭	wphv
燰	wphw
未	wpi
桅	wpip
梶	wpiq
楲	wpis
椳	wpit
椲	wpiu
欈	wpiv
卫	wpj
帷	wpjc
帏	wpjp
幃	wpjq
覣	wpjs
鍡	wpjt
鍏	wpju
鏏	wpjv
覹	wpjw
褽	wpkq
胃	wpl
腲	wplq
闱	wpm
闈	wpmq
瞆	wpms
矀	wpmt
委	wpn
娓	wpnp
媙	wpnq
媦	wpns
媁	wpnt
犚	wpnu
犩	wpnv
味	wpo
喂	wpoc
唯	wpop
唩	wpoq
喴	wpos
喡	wpot
尾	wpp
硙	wppq
硊	wpps
碨	wppt
磈	wppu
磑	wppv
猥	wpq
猬	wpqp
猚	wpqq
醀	wpqs
暐	wprq
霨	wprs
霺	wprt
巍	wps
嵬	wpsc
饖	wpso
崴	wpsp
餵	wpsq
峗	wpss
峞	wpst
崣	wpsu
嵔	wpsv
嶉	wpsw
罻	wpsx
嶶	wpsy
餧	wpsz
畏	wpt
圩	wptp
墛	wptq
壝	wpts
亹	wptt
蔚	wpu
苇	wpuc
葳	wpud
薇	wpue
蘶	wpum
藯	wpun
薳	wpuo
萎	wpup
葦	wpuq
芛	wpus
苿	wput
荱	wpuu
菋	wpuv
葨	wpuw
蒍	wpux
蓶	wpuy
蔿	wpuz
位	wpv
伪	wpvc
偎	wpvd
伟	wpvp
偽	wpvq
偉	wpvs
僞	wpvt
儰	wpvu
围	wpw
玮	wpwc
韪	wpwd
斖	wpwo
韦	wpwp
韋	wpwq
圍	wpws
瑋	wpwt
韙	wpwu
囲	wpwv
琟	wpww
韑	wpwx
韡	wpwy
瓗	wpwz
慰	wpx
惟	wpxp
愄	wpxq
愇	wpxs
懀	wpxt
谓	wpy
鲔	wpyc
讏	wpyk
讆	wpyl
鰃	wpym
鰄	wpyn
鳚	wpyo
诿	wpyp
謂	wpyq
諉	wpys
鮪	wpyt
叞	wpyu
詴	wpyv
頠	wpyw
鮇	wpyx
鳂	wpyy
鮠	wpyz
违	wpz
艉	wpzc
逶	wpzp
違	wpzq
遺	wpzs
爲	wpzt
踓	wpzu
躗	wpzv
躛	wpzw
捂	wua
扜	wuaq
扝	wuas
扤	wuat
摀	wuau
勿	wub
寤	wubc
痦	wubp
鼿	wubq
齀	wubs
蜈	wuc
螐	wucq
蟱	wucs
剭	wudq
奦	wuds
污	wue
浯	wuep
汙	wueq
汚	wues
沕	wuet
洿	wueu
洖	wuev
渞	wuew
溩	wuex
潕	wuey
阢	wuf
邬	wufp
鄔	wufq
郚	wufs
陚	wuft
隖	wufu
巫	wug
庑	wugc
戊	wugp
廡	wugq
弙	wugs
靰	wugt
无	wuh
焐	wuhc
五	wuhp
烏	wuhq
無	wuhs
熓	wuht
熃	wuhu
梧	wui
杌	wuip
杅	wuiq
杇	wuis
柮	wuit
橆	wuiu
钨	wuj
鋈	wujp
鎢	wujq
卼	wujs
釫	wujt
铻	wuju
鋙	wujv
鋘	wujw
箼	wukq
务	wul
務	wulq
膴	wuls
毋	wum
骛	wump
騖	wumq
粅	wums
瞴	wumt
物	wun
牾	wunc
婺	wund
鹉	wune
鹜	wunf
鷡	wuno
妩	wunp
嫵	wunq
鵡	wuns
鶩	wunt
娪	wunu
娒	wunv
娬	wunw
鹀	wunx
鴮	wuny
鵐	wunz
吴	wuo
吾	wuoc
唔	wuod
呜	wuop
吳	wuoq
嗚	wuos
呉	wuot
啎	wuou
屋	wup
乌	wupc
午	wupp
矹	wupq
碔	wups
歍	wuqq
雾	wur
晤	wurp
霧	wurq
旿	wurs
雺	wurt
霚	wuru
鼯	wus
屼	wusq
岉	wuss
峿	wust
祦	wusu
嵍	wusv
嵨	wusw
坞	wut
圬	wutp
塢	wutq
堥	wuts
墲	wutt
芜	wuu
芴	wuup
蕪	wuuq
莁	wuus
茣	wuut
蘁	wuuu
伍	wuv
仵	wuvc
侮	wuvp
乄	wuvq
亾	wuvs
俉	wuvt
倵	wuvu
僫	wuvv
儛	wuvw
兀	wuw
玝	wuwq
敄	wuws
珸	wuwt
珷	wuwu
瑦	wuwv
璑	wuww
甒	wuwx
恶	wux
悟	wuxc
怃	wuxd
忤	wuxe
舞	wuxp
惡	wuxq
憮	wuxs
忢	wuxt
悮	wuxu
悞	wuxv
窏	wuxw
窹	wuxx
误	wuy
诬	wuyp
誣	wuyq
誤	wuys
誈	wuyt
鯃	wuyu
譕	wuyv
鰞	wuyw
武	wuz
迕	wuzp
逜	wuzq
趶	wuzs
躌	wuzt
攚	wzaq
齆	wzbq
螉	wzcq
奣	wzdq
滃	wzeq
聬	wzfq
罋	wzfs
鎓	wzjq
勜	wzlq
瞈	wzmq
鹟	wznq
鶲	wzns
嗡	wzo
暡	wzrq
嵡	wzsq
塕	wztq
蓊	wzu
蕹	wzup
瓮	wzw
甕	wzwq
翁	wzy
疦	xgbq
疶	xgbs
轌	xgcq
削	xgd
泶	xge
澩	xgeq
泬	xges
滈	xget
瀥	xgeu
靴	xgg
鞾	xggq
燢	xghq
桖	xgiq
樰	xgis
觷	xgjq
袕	xgkq
膤	xglq
瞲	xgmq
鸴	xgnq
鷽	xgns
噱	xgo
吷	xgoq
狘	xgqq
雪	xgr
岤	xgsq
峃	xgss
嶨	xgst
坹	xgtq
壆	xgts
薛	xgu
茓	xguq
蒆	xgus
乴	xgvq
斈	xgwq
敩	xgws
斆	xgwt
血	xgx
彐	xgxc
穴	xgxp
怴	xgxq
辥	xgxs
辪	xgxt
谑	xgy
鳕	xgyp
謔	xgyq
鱈	xgys
学	xgz
踅	xgzp
學	xgzq
趐	xgzs
艝	xgzt
扢	xiaq
扱	xias
扸	xiat
摡	xiau
兮	xib
皙	xibp
卥	xibq
瘜	xibs
凞	xibt
徙	xic
螅	xicc
蟋	xicd
蜥	xicp
徆	xicq
赥	xics
赩	xict
徯	xicu
螇	xicv
蟢	xicw
蠵	xicx
奚	xid
鬩	xidq
洗	xie
汐	xiec
浠	xied
淅	xiee
溪	xiep
渓	xieq
滊	xies
漇	xiet
漝	xieu
澙	xiev
潟	xiew
潝	xiex
系	xif
隙	xifc
郗	xifd
隰	xife
酅	xifi
隵	xifj
繫	xifk
繥	xifl
縰	xifm
縘	xifn
緆	xifo
细	xifp
細	xifq
郤	xifs
匸	xift
邜	xifu
郋	xifv
绤	xifw
鄎	xifx
隟	xify
綌	xifz
戏	xig
席	xigp
戲	xigq
戯	xigs
戱	xigt
豀	xigu
谿	xigv
稀	xih
熄	xihc
烯	xihd
熹	xihe
爔	xihk
虩	xihl
燨	xihm
熻	xihn
熺	xiho
熙	xihp
焁	xihq
焈	xihs
焟	xiht
焬	xihu
煕	xihv
稧	xihw
熈	xihx
熂	xihy
黖	xihz
析	xii
檄	xiic
樨	xiid
橀	xiio
栖	xiip
棲	xiiq
杫	xiis
枲	xiit
桸	xiiu
椞	xiiv
椺	xiiw
榽	xiix
槢	xiiy
橲	xiiz
希	xij
铣	xijc
觋	xijd
舄	xije
鐊	xiji
鏭	xijj
鎴	xijk
覤	xijl
鉨	xijm
鉩	xijn
厀	xijo
锡	xijp
銑	xijq
錫	xijs
覡	xijt
钑	xiju
釳	xijv
釸	xijw
鈒	xijx
舃	xijy
鈢	xijz
袭	xik
裼	xikp
襲	xikq
膝	xil
臘	xilq
肸	xils
肹	xilt
釐	xilu
阋	xim
粞	ximp
盻	ximq
睎	xims
瞦	ximt
糦	ximu
騱	ximv
闟	ximw
騽	ximx
矖	ximy
驨	ximz
媳	xin
嬉	xinc
牺	xinp
犧	xinq
娭	xins
犔	xint
嬆	xinu
犠	xinv
鵗	xinw
鸂	xinx
喜	xio
嘻	xioc
唏	xiod
吸	xiop
呬	xioq
咥	xios
唽	xiot
喺	xiou
噏	xiov
嚱	xiow
囍	xiox
犀	xip
硒	xipc
屣	xipd
矽	xipp
屃	xipq
屓	xips
屖	xipt
碏	xipu
磎	xipv
礂	xipw
磶	xipx
屭	xipy
欷	xiq
醯	xiqc
歙	xiqp
欪	xiqq
欯	xiqs
氥	xiqt
狶	xiqu
獡	xiqv
歖	xiqw
晰	xir
曦	xirc
昔	xirp
雭	xirq
晞	xirs
晳	xirt
暿	xiru
霫	xirv
霼	xirw
饩	xis
禧	xisc
鼷	xisd
饎	xism
巇	xisn
巂	xiso
禊	xisp
餼	xisq
卌	xiss
饻	xist
嵠	xisu
豨	xisv
嶍	xisw
餏	xisx
嶲	xisy
豯	xisz
塈	xitq
塜	xits
墍	xitt
壐	xitu
茜	xiu
葸	xiuc
蓰	xiud
菥	xiup
莃	xiuq
葈	xius
蒨	xiut
蒠	xiuu
蒵	xiuv
蓆	xiuw
蕮	xiux
薂	xiuy
习	xiv
僖	xivp
俙	xivq
係	xivs
傒	xivt
玺	xiw
璽	xiwq
琋	xiws
瓕	xiwt
西	xix
惜	xixc
悉	xixd
夕	xixe
穸	xixf
衋	xixk
窸	xixl
憙	xixm
憘	xixn
慀	xixo
息	xixp
愾	xixq
忚	xixs
忥	xixt
怬	xixu
怸	xixv
恄	xixw
恓	xixx
悕	xixy
惁	xixz
翕	xiy
鱚	xiyl
鰼	xiym
譆	xiyn
鳛	xiyo
羲	xiyp
習	xiyq
鰓	xiys
誒	xiyt
羛	xiyu
翖	xiyv
諰	xiyw
謑	xiyx
鯑	xiyy
謵	xiyz
舾	xiz
蹊	xizp
趇	xizq
趘	xizs
貕	xizt
蹝	xizu
雟	xizv
躧	xizw
掀	xja
摻	xjaq
搟	xjas
挦	xjat
搚	xjau
撊	xjav
撏	xjaw
攇	xjax
攕	xjay
宪	xjb
冼	xjbc
痫	xjbd
贤	xjbp
賢	xjbq
癇	xjbs
癎	xjbt
贒	xjbu
衔	xjc
蚬	xjcp
蜆	xjcq
臤	xjcs
軐	xjct
蚿	xjcu
蛝	xjcv
衘	xjcw
輱	xjcx
豏	xjdq
先	xje
涎	xjep
涀	xjeq
湺	xjes
溓	xjet
澖	xjeu
瀗	xjev
灦	xjew
线	xjf
限	xjfc
陷	xjfd
纤	xjfe
纎	xjfk
繊	xjfl
綫	xjfm
綅	xjfn
綖	xjfo
险	xjfp
險	xjfq
線	xjfs
縣	xjft
纖	xjfu
陥	xjfv
険	xjfw
絃	xjfx
缐	xjfy
絤	xjfz
咸	xjg
弦	xjgp
廯	xjgq
韅	xjgs
燹	xjh
秈	xjhq
烍	xjhs
稴	xjht
杴	xjiq
枮	xjis
槏	xjit
橺	xjiu
橌	xjiv
櫶	xjiw
见	xjj
锨	xjjc
鑦	xjji
鏾	xjjj
幰	xjjk
鍌	xjjl
韱	xjjm
錎	xjjn
銽	xjjo
铣	xjjp
見	xjjq
銜	xjjs
銑	xjjt
鍁	xjju
臽	xjjv
铦	xjjw
銛	xjjx
韯	xjjy
鋧	xjjz
筅	xjk
箲	xjkq
褼	xjks
襳	xjkt
腺	xjl
鹹	xjlq
胘	xjls
臔	xjlt
麙	xjlu
闲	xjm
糮	xjmo
籼	xjmp
閑	xjmq
盷	xjms
県	xjmt
毨	xjmu
睍	xjmv
閒	xjmw
粯	xjmx
瞯	xjmy
麲	xjmz
嫌	xjn
鹇	xjnc
鷳	xjnj
鷼	xjnk
鶱	xjnl
孅	xjnm
嬐	xjnn
嫺	xjno
娴	xjnp
嫻	xjnq
鷴	xjns
奾	xjnt
妶	xjnu
姺	xjnv
姭	xjnw
娊	xjnx
婱	xjny
娹	xjnz
咞	xjoq
咁	xjos
唌	xjot
哯	xjou
啣	xjov
嗛	xjow
嘕	xjox
硍	xjpq
礥	xjps
献	xjq
猃	xjqc
酰	xjqd
氙	xjqp
獻	xjqq
獫	xjqs
欦	xjqt
狝	xjqu
醎	xjqv
獮	xjqw
醶	xjqx
玁	xjqy
显	xjr
霰	xjrp
晛	xjrq
县	xjs
岘	xjsc
祆	xjsd
馅	xjsp
餡	xjsq
峴	xjss
屳	xjst
崄	xjsu
禒	xjsv
嶮	xjsw
鼸	xjsx
垷	xjtq
埳	xjts
塪	xjtt
壏	xjtu
苋	xju
藓	xjuc
莶	xjup
莧	xjuq
薟	xjus
蘚	xjut
苮	xjuu
藖	xjuv
仙	xjv
仚	xjvq
佡	xjvs
伭	xjvt
僊	xjvu
僲	xjvv
僴	xjvw
僩	xjvx
现	xjw
現	xjwq
玹	xjws
珗	xjwt
甉	xjwu
憲	xjxq
忺	xjxs
尠	xjxt
尟	xjxu
憪	xjxv
憸	xjxw
懢	xjxx
馦	xjxy
鲜	xjy
鱻	xjyo
羡	xjyp
羨	xjyq
鮮	xjys
顯	xjyt
誢	xjyu
誸	xjyv
羬	xjyw
諴	xjyx
顕	xjyy
譣	xjyz
舷	xjz
跹	xjzc
暹	xjzd
跣	xjzp
躚	xjzq
赻	xjzs
蹮	xjzt
揗	xkaq
巽	xkb
寻	xkc
徇	xkcc
循	xkcp
尋	xkcq
蟫	xkcs
蟳	xkct
殉	xkd
奞	xkdq
浚	xke
洵	xkec
浔	xked
汛	xkep
潯	xkeq
潠	xkes
濬	xket
灥	xkeu
郇	xkf
紃	xkfq
鄩	xkfs
纁	xkft
熏	xkh
焄	xkhq
稄	xkhs
煇	xkht
燅	xkhu
燖	xkhv
燻	xkhw
爓	xkhx
爋	xkhy
杊	xkiq
栒	xkis
桪	xkit
樳	xkiu
鑂	xkjq
勋	xkl
勛	xklq
勲	xkls
勳	xklt
臐	xklu
驯	xkm
馴	xkmq
毥	xkms
眴	xkmt
駨	xkmu
矄	xkmv
姰	xknq
鶽	xkns
咰	xkoq
噚	xkos
噀	xkot
嚑	xkou
殾	xkpq
獯	xkq
醺	xkqp
狥	xkqq
旬	xkr
曛	xkrp
峋	xks
卂	xksq
巺	xkss
埙	xkt
塤	xktq
坃	xkts
畃	xktt
壎	xktu
壦	xktv
荀	xku
蕈	xkuc
薰	xkud
荨	xkup
葷	xkuq
蕁	xkus
薫	xkut
蘍	xkuu
伨	xkvq
侚	xkvs
偱	xkvt
珣	xkwq
璕	xkws
恂	xkx
窨	xkxp
愻	xkxq
训	xky
询	xkyc
鲟	xkyd
讯	xkyp
訓	xkyq
訊	xkys
詢	xkyt
鱘	xkyu
廵	xkyv
訙	xkyw
顨	xkyx
鱏	xkyy
迅	xkz
逊	xkzc
巡	xkzp
孫	xkzq
遜	xkzs
迿	xkzt
攳	xkzu
揱	xmaq
撨	xmas
宵	xmb
宯	xmbq
痚	xmbs
痟	xmbt
皛	xmbu
皢	xmbv
蛸	xmc
蟏	xmcq
蟂	xmcs
蟰	xmct
蠨	xmcu
削	xmd
消	xme
潇	xmec
淆	xmep
瀟	xmeq
洨	xmes
涍	xmet
绡	xmf
綃	xmfq
郩	xmfs
颵	xmft
魈	xmg
庨	xmgq
骹	xmgs
彇	xmgt
髇	xmgu
髐	xmgv
灲	xmhq
灱	xmhs
烋	xmht
虓	xmhu
焇	xmhv
熇	xmhw
穘	xmhx
熽	xmhy
校	xmi
枵	xmic
枭	xmip
梟	xmiq
櫹	xmis
销	xmj
銷	xmjq
笑	xmk
箫	xmkc
筱	xmkp
簫	xmkq
筿	xmks
箾	xmkt
篠	xmku
簘	xmkv
肖	xml
効	xmlq
膮	xmls
骁	xmm
驍	xmmq
睄	xmms
鸮	xmnq
婋	xmns
鴞	xmnt
鴵	xmnu
鷍	xmnv
啸	xmo
哮	xmoc
哓	xmod
嚻	xmoo
嚣	xmop
嘯	xmoq
囂	xmos
嘵	xmot
呺	xmou
咲	xmov
嗃	xmow
嘋	xmox
嘨	xmoy
嘐	xmoz
硝	xmp
硣	xmpq
殽	xmps
毊	xmpt
猇	xmqq
歊	xmqs
獟	xmqt
獢	xmqu
歗	xmqv
晓	xmr
霄	xmrp
曉	xmrq
暁	xmrs
崤	xms
萧	xmu
蕭	xmuq
莦	xmus
薂	xmut
藃	xmuu
虈	xmuv
侾	xmvq
俲	xmvs
傚	xmvt
效	xmw
敩	xmwq
斅	xmws
斆	xmwt
小	xmx
恔	xmxq
窙	xmxs
憢	xmxt
訤	xmyq
翛	xmys
詨	xmyt
誟	xmyu
誵	xmyv
謏	xmyw
孝	xmz
逍	xmzp
踃	xmzq
髹	xnb
髤	xnbq
齅	xnbs
螑	xncq
溴	xne
滫	xneq
潃	xnes
绣	xnf
繡	xnfq
綉	xnfs
繍	xnft
飍	xnfu
庥	xng
秀	xnh
烌	xnhq
朽	xni
樇	xniq
锈	xnj
銹	xnjq
銝	xnjs
鎀	xnjt
鏅	xnju
鏥	xnjv
鏽	xnjw
袖	xnk
褏	xnkq
褎	xnks
脩	xnlq
脙	xnls
糔	xnmq
鸺	xnn
鵂	xnnq
嗅	xno
咻	xnop
嚊	xnoq
岫	xns
馐	xnsp
饈	xnsq
峀	xnss
苬	xnuq
修	xnv
休	xnvp
俢	xnvq
珛	xnwq
琇	xnws
璓	xnwt
羞	xny
鮴	xnyq
鱃	xnys
臭	xnz
貅	xnzp
臹	xnzq
厢	xqc
蟓	xqcp
蚃	xqcq
衖	xqcs
蠁	xqct
忀	xqcu
湘	xqe
潒	xqeq
降	xqf
缃	xqfp
鄉	xqfq
緗	xqfs
郷	xqft
鄊	xqfu
缿	xqfv
鄕	xqfw
絴	xqfx
纕	xqfy
庠	xqg
廂	xqgq
相	xqi
橡	xqip
栙	xqiq
楿	xqis
欀	xqit
镶	xqj
鑲	xqjq
銄	xqjs
銗	xqjt
鐌	xqju
箱	xqk
襐	xqkq
勨	xqlq
膷	xqls
勷	xqlt
麘	xqlu
骧	xqm
驤	xqmq
閧	xqms
闂	xqmt
姠	xqnq
向	xqo
响	xqop
啍	xqoq
嚮	xqos
晑	xqrq
曏	xqrs
象	xqs
巷	xqsc
饷	xqsd
飨	xqse
祥	xqsp
餉	xqsq
饗	xqss
嶑	xqst
饟	xqsu
享	xqt
襄	xqtp
亯	xqtq
芗	xqu
葙	xqup
薌	xquq
萫	xqus
像	xqv
乡	xqvp
佭	xqvq
儴	xqvs
瓨	xqwq
珦	xqws
瓖	xqwt
想	xqx
香	xqxp
项	xqy
详	xqyc
鲞	xqyd
翔	xqyp
項	xqyq
詳	xqys
響	xqyt
鯗	xqyu
羏	xqyv
鮝	xqyw
鱌	xqyx
鱜	xqyy
鱶	xqyz
夅	xqzq
跭	xqzs
揎	xra
宣	xrb
痃	xrbc
癣	xrbp
癬	xrbq
贙	xrbs
轩	xrc
軒	xrcq
衒	xrcs
蜁	xrct
蝖	xrcu
蠉	xrcv
泫	xre
漩	xrec
渲	xrep
旋	xrf
绚	xrfp
絢	xrfq
縣	xrfs
縇	xrft
颴	xrfu
縼	xrfv
繏	xrfw
弲	xrgq
鞙	xrgs
炫	xrh
煊	xrhp
烜	xrhq
煖	xrhs
楦	xri
梋	xriq
楥	xris
檈	xrit
铉	xrj
镟	xrjp
鉉	xrjq
鏇	xrjs
鋗	xrjt
鍹	xrju
袨	xrkq
箮	xrks
眩	xrm
眴	xrmq
睻	xrms
駨	xrmt
駽	xrmu
矎	xrmv
妶	xrnq
媗	xrns
嫙	xrnt
嬛	xrnu
喧	xro
吅	xroq
咺	xros
喛	xrot
碹	xrp
暄	xrr
昍	xrrq
昡	xrrs
晅	xrrt
暅	xrru
暶	xrrv
禤	xrsq
塇	xrtq
萱	xru
萲	xruq
蓒	xrus
蔙	xrut
蕿	xruu
蘐	xruv
藼	xruw
儇	xrv
伭	xrvq
璇	xrw
玹	xrwq
琄	xrws
琁	xrwt
瑄	xrwu
敻	xrwv
璿	xrww
玄	xrx
悬	xrxp
懸	xrxq
怰	xrxs
愋	xrxt
愃	xrxu
懁	xrxv
谖	xry
諼	xryq
翧	xrys
諠	xryt
翾	xryu
鰚	xryv
譞	xryw
讂	xryx
选	xrz
選	xrzq
夐	xrzs
匈	xsb
匂	xsbq
賯	xsbs
兄	xse
汹	xsep
兇	xseq
洶	xses
熊	xsh
焸	xshq
焽	xshs
熋	xsht
凶	xsk
胸	xsl
胷	xslq
哅	xsoq
芎	xsu
敻	xswq
忷	xsxq
恟	xsxs
讻	xsyq
诇	xsys
訩	xsyt
詗	xsyu
詾	xsyv
雄	xsz
夐	xszq
携	xta
撷	xtac
挟	xtap
挾	xtaq
攜	xtas
擷	xtat
拹	xtau
揳	xtav
搚	xtaw
擕	xtax
寫	xtbq
卨	xtbs
禼	xtbt
齂	xtbu
蝎	xtc
蟹	xtcp
蠍	xtcq
徢	xtcs
蝢	xtct
齘	xtcu
蠏	xtcv
齛	xtcw
齥	xtcx
斜	xtd
奊	xtdq
些	xte
泻	xtec
渫	xted
瀣	xtee
泄	xtep
瀉	xteq
洩	xtes
滊	xtet
澥	xteu
邪	xtf
缬	xtfc
繲	xtfn
縀	xtfo
绁	xtfp
紲	xtfq
纈	xtfs
缷	xtft
絜	xtfu
絏	xtfv
絬	xtfw
綊	xtfx
緳	xtfy
緤	xtfz
鞋	xtg
廨	xtgp
靾	xtgq
鞢	xtgs
鞵	xtgt
灺	xthq
炧	xths
炨	xtht
烲	xthu
焎	xthv
熁	xthw
燲	xthx
爕	xthy
械	xti
榭	xtic
榍	xtid
楔	xtip
枻	xtiq
栧	xtis
梋	xtit
榝	xtiu
樧	xtiv
卸	xtj
觟	xtjq
觧	xtjs
韰	xtjt
褻	xtkq
衺	xtks
褉	xtkt
襭	xtku
胁	xtl
勰	xtlp
脅	xtlq
劦	xtls
脇	xtlt
脋	xtlu
膎	xtlv
写	xtm
冩	xtmq
糏	xtms
娎	xtnq
媟	xtns
孈	xtnt
嗋	xtoq
噧	xtos
嚡	xtot
屑	xtp
屟	xtpq
碿	xtps
屧	xtpt
歇	xtq
獬	xtqp
猲	xtqq
獦	xtqs
旪	xtrq
暬	xtrs
协	xts
協	xtsq
祄	xtss
峫	xtst
嶰	xtsu
亵	xtt
垥	xttq
塮	xtts
薤	xtu
薢	xtuq
藛	xtus
偕	xtv
伳	xtvq
偰	xtvs
偞	xtvt
僁	xtvu
儶	xtvv
瑎	xtwq
韘	xtws
懈	xtx
恊	xtxq
慀	xtxs
愶	xtxt
谢	xty
颉	xtyc
燮	xtyd
谐	xtyp
諧	xtyq
謝	xtys
頡	xtyt
鮭	xtyu
翓	xtyv
讗	xtyw
龤	xtyx
蹀	xtz
躞	xtzc
邂	xtzp
夑	xtzq
躠	xtzs
掝	xuaq
揟	xuas
疞	xubq
賉	xubs
鬚	xubt
徐	xuc
蚼	xucq
蛡	xucs
蝑	xuct
殈	xudq
洫	xue
溆	xuep
漵	xueq
滸	xues
汿	xuet
沀	xueu
淢	xuev
湏	xuew
湑	xuex
滀	xuey
潊	xuez
续	xuf
絮	xufc
繻	xufn
縃	xufo
绪	xufp
緒	xufq
續	xufs
聓	xuft
続	xufu
綇	xufv
鄦	xufw
聟	xufx
緖	xufy
緰	xufz
序	xug
戌	xugp
魆	xugq
魖	xugs
虚	xuh
煦	xuhp
虛	xuhq
烅	xuhs
虗	xuht
烼	xuhu
稰	xuhv
稸	xuhw
燸	xuhx
栩	xui
楈	xuiq
槒	xuis
卹	xujq
銊	xujs
鑐	xujt
裇	xukq
肷	xul
勖	xulc
胥	xulp
勗	xulq
盱	xum
糈	xump
眗	xumq
矞	xums
瞁	xumt
盢	xumu
盨	xumv
驉	xumw
婿	xun
姁	xunq
妶	xuns
媭	xunt
嬃	xunu
吁	xuo
嘘	xuop
噓	xuoq
呴	xuos
喐	xuot
喣	xuou
嘼	xuov
酗	xuq
醑	xuqp
欨	xuqq
欰	xuqs
欻	xuqt
歔	xuqu
獝	xuqv
歘	xuqw
需	xur
旭	xurp
旴	xurq
昫	xurs
晇	xurt
朂	xuru
暊	xurv
壻	xusq
禑	xuss
畜	xut
圩	xutc
墟	xutp
垿	xutq
冔	xuts
蓄	xuu
蓿	xuup
芧	xuuq
蒣	xuus
蓲	xuut
蕦	xuuu
藇	xuuv
藚	xuuw
伵	xuvq
侐	xuvs
俆	xuvt
偦	xuvu
敘	xuwq
珬	xuws
珝	xuwt
敍	xuwu
恤	xux
怴	xuxq
恓	xuxs
惐	xuxt
慉	xuxu
许	xuy
叙	xuyc
诩	xuyd
顼	xuye
鱮	xuym
譃	xuyn
諝	xuyo
须	xuyp
許	xuyq
須	xuys
頊	xuyt
詡	xuyu
訏	xuyv
谞	xuyw
訹	xuyx
魣	xuyy
諿	xuyz
捾	xwaq
疜	xwbq
疨	xwbs
厦	xwc
虾	xwcc
辖	xwcp
蝦	xwcq
轄	xwcs
徦	xwct
赮	xwcu
螛	xwcv
夾	xwdq
匣	xwf
罅	xwfp
陜	xwfq
陿	xwfs
颬	xwft
縖	xwfu
廈	xwgq
谺	xwgs
下	xwh
黠	xwhp
煆	xwhq
丅	xwhs
炠	xwht
烚	xwhu
柙	xwi
梺	xwiq
鍜	xwjq
鎼	xwjs
鎋	xwjt
鏬	xwju
笚	xwkq
筪	xwks
瞎	xwm
閕	xwmq
閜	xwms
睱	xwmt
騢	xwmu
鶷	xwnq
吓	xwo
呷	xwop
嚇	xwoq
硖	xwp
硤	xwpq
碬	xwps
磍	xwpt
狭	xwq
狎	xwqp
狹	xwqq
猇	xwqs
霞	xwr
暇	xwrp
峡	xws
峽	xwsq
祫	xwss
圷	xwtq
埉	xwts
芐	xwuq
蕸	xwus
侠	xwv
俠	xwvq
傄	xwvs
瑕	xww
珨	xwwq
敮	xwws
舝	xwwt
懗	xwxq
叚	xwyq
翈	xwys
諕	xwyt
魻	xwyu
鰕	xwyv
夏	xwz
遐	xwzp
舺	xwzq
夓	xwzs
軐	xxcq
阠	xxfq
邤	xxfs
廞	xxgq
炘	xxhq
焮	xxhs
枔	xxiq
杺	xxis
新	xxj
镡	xxjc
鑫	xxjd
锌	xxjp
鋅	xxjq
鐔	xxjs
鈊	xxjt
舋	xxju
襑	xxkq
脪	xxlq
盺	xxmq
馸	xxms
妡	xxnq
嬜	xxns
噺	xxoq
噷	xxos
囟	xxp
礥	xxpq
欣	xxq
歆	xxqp
釁	xxqq
昕	xxr
薪	xxu
莘	xxuc
芯	xxup
信	xxv
伩	xxvq
伈	xxvs
俽	xxvt
心	xxx
衅	xxxc
忻	xxxd
忄	xxxe
馨	xxxf
辛	xxxp
惞	xxxq
愖	xxxs
馫	xxxt
訢	xxyq
訫	xxys
顖	xxyt
孞	xxzq
擤	xya
兴	xyb
皨	xybq
行	xyc
巠	xycq
蛵	xycs
刑	xyd
滎	xyeq
洐	xyes
涬	xyet
邢	xyf
陉	xyfp
陘	xyfq
郉	xyfs
緈	xyft
煋	xyhq
杏	xyi
興	xyjq
钘	xyjs
铏	xyjt
鈃	xyju
銒	xyjv
鉶	xyjw
觪	xyjx
鋞	xyjy
觲	xyjz
箵	xykq
篂	xyks
腥	xyl
臖	xylq
省	xym
骍	xymq
睲	xyms
騂	xymt
姓	xyn
娙	xynq
婞	xyns
嬹	xynt
哘	xyoq
硎	xyp
醒	xyq
猩	xyqp
狌	xyqq
星	xyr
曐	xyrq
形	xys
饧	xysp
餳	xysq
幸	xyt
型	xytp
垶	xytq
荇	xyu
荥	xyup
莕	xyuq
葕	xyus
侀	xyvq
倖	xyvs
瑆	xywq
性	xyx
悻	xyxc
惺	xyxp
鮏	xyyq
謃	xyys
鯹	xyyt
飁	xzfv
纚	xzfw
觹	xzjq
觽	xzjs
觿	xzjt
鑴	xzju
押	yaa
揠	yaap
拁	yaaq
挜	yaas
掗	yaat
痖	yab
瘂	yabq
冴	yabs
疨	yabt
压	yac
轧	yacc
蚜	yacd
衙	yacp
軋	yacq
厭	yacs
厊	yact
厑	yacu
厓	yacv
齖	yacw
齾	yacx
涯	yae
漄	yaeq
潝	yaes
聐	yafq
庌	yagq
庘	yags
亚	yah
亞	yahq
亜	yahs
稏	yaht
桠	yai
椏	yaiq
枒	yais
椻	yait
铔	yajq
釾	yajs
錏	yajt
鐚	yaju
笌	yakq
丫	yal
劜	yalq
睚	yam
鸭	yan
娅	yanc
鸦	yanp
鴉	yanq
鴨	yans
婭	yant
姶	yanu
鵶	yanv
呀	yao
哑	yaop
啞	yaoq
唖	yaos
砑	yap
磍	yapq
氩	yaq
氬	yaqq
犽	yaqs
猚	yaqt
猰	yaqu
崖	yas
岈	yasp
崕	yasq
垭	yat
壓	yatq
埡	yats
圠	yatt
圧	yatu
堐	yatv
芽	yau
蕥	yauq
伢	yav
俹	yavq
琊	yaw
玡	yawq
圔	yaws
瓛	yawt
襾	yaxq
覀	yaxs
窫	yaxt
牙	yay
讶	yayp
訝	yayq
雅	yaz
迓	yazp
孲	yazq
摇	yca
搖	ycaq
抭	ycas
揺	ycat
摿	ycau
撽	ycav
瘧	ycbq
宎	ycbs
匋	ycbt
皐	ycbu
鼼	ycbv
轺	ycc
徭	yccp
軺	yccq
徺	yccs
齩	ycct
夭	ycd
殀	ycdq
滧	yceq
溔	yces
繇	ycf
約	ycfq
隃	ycfs
飖	ycft
颻	ycfu
纅	ycfv
靿	ycgq
烑	ychq
烄	ychs
熎	ycht
燿	ychu
杳	yci
枖	yciq
柼	ycis
楆	ycit
榣	yciu
榚	yciv
钥	ycj
铫	ycjc
舀	ycjp
鑰	ycjq
銚	ycjs
覞	ycjt
鎐	ycju
袎	yckq
筄	ycks
箹	yckt
腰	ycl
肴	yclp
麽	ycm
眑	ycmq
闄	ycms
騕	ycmt
矅	ycmu
姚	ycn
鹞	ycnc
妖	ycnp
鷂	ycnq
婹	ycns
媱	ycnt
鴁	ycnu
鴢	ycnv
鷕	ycnw
咬	yco
吆	ycop
喓	ycoq
嗂	ycos
殽	ycpq
磘	ycps
狕	ycqq
猺	ycqs
獟	ycqt
曜	ycr
暚	ycrq
崾	ycs
岆	ycsq
祅	ycss
峣	ycst
餆	ycsu
嶢	ycsv
嶤	ycsw
餚	ycsx
堯	yctq
垚	ycts
药	ycu
藥	ycuq
蕘	ycus
苭	ycut
葽	ycuu
葯	ycuv
蓔	ycuw
薬	ycux
蘨	ycuy
僥	ycvq
仸	ycvs
倄	ycvt
偠	ycvu
傜	ycvv
瑶	ycw
珧	ycwc
尧	ycwp
瑤	ycwq
要	ycx
爻	ycxc
窈	ycxd
窑	ycxp
窯	ycxq
怮	ycxs
恌	ycxt
穾	ycxu
窅	ycxv
窔	ycxw
愮	ycxx
窰	ycxy
耀	ycy
幺	ycyc
鳐	ycyd
谣	ycyp
謠	ycyq
鰩	ycys
尭	ycyt
訞	ycyu
詏	ycyv
謡	ycyw
顤	ycyx
鱙	ycyy
讑	ycyz
遥	ycz
邀	yczp
遙	yczq
艞	yczs
邎	yczt
拽	yea
揶	yeac
揲	yead
掖	yeap
抴	yeaq
捓	yeas
捙	yeat
擛	yeau
擖	yeav
擫	yeaw
擨	yeax
擪	yeay
冶	yeb
痷	yebq
皣	yebs
靥	yec
蠮	yecq
殗	yedq
液	yee
洂	yeeq
漜	yees
潱	yeet
澲	yeeu
爷	yef
邺	yefc
耶	yefp
爺	yefq
鄴	yefs
緤	yeft
烨	yeh
燁	yehq
焆	yehs
煠	yeht
爗	yehu
椰	yei
業	yeiq
枼	yeis
枽	yeit
楪	yeiu
铘	yej
鋣	yejq
釾	yejs
鎁	yejt
鍱	yeju
鎑	yejv
鐷	yejw
野	yel
腋	yelc
曳	yelp
靨	yemq
瞱	yems
瞸	yemt
驜	yemu
鵺	yenq
鸈	yens
叶	yeo
噎	yeop
吔	yeoq
嘢	yeos
嚥	yeot
礏	yepq
歋	yeqq
晔	yer
曄	yerq
曵	yers
暍	yert
曅	yeru
曗	yerv
峫	yesq
馌	yess
嶪	yest
嶫	yesu
餣	yesv
饁	yesw
亪	yetq
亱	yets
埜	yett
堨	yetu
墷	yetv
壄	yetw
葉	yeuq
也	yev
倻	yevq
僷	yevs
瑘	yewq
璍	yews
瓛	yewt
夜	yex
窫	yexq
业	yey
谒	yeyc
页	yeyp
頁	yeyq
謁	yeys
揂	yfaq
卣	yfb
宥	yfbc
疣	yfbp
痏	yfbq
釉	yfc
蚴	yfcc
蝣	yfcd
蝤	yfce
蚰	yfcp
蜏	yfcq
輏	yfcs
輶	yfct
油	yfe
游	yfep
沋	yfeq
汼	yfes
泑	yfet
浟	yfeu
湵	yfev
滺	yfew
瀀	yfex
邮	yff
繇	yffp
郵	yffq
斿	yffs
聈	yfft
鄾	yffu
纋	yffv
庮	yfgq
黝	yfh
丣	yfhq
秞	yfhs
柚	yfi
栯	yfiq
梄	yfis
梎	yfit
楢	yfiu
槱	yfiv
櫌	yfiw
櫾	yfix
铀	yfj
铕	yfjp
鈾	yfjq
銪	yfjs
褏	yfkq
褎	yfks
有	yfl
肬	yflq
麀	yfls
耰	yflt
冘	yfmq
駀	yfms
妋	yfnq
牰	yfns
姷	yfnt
右	yfo
呦	yfop
哊	yfoq
唀	yfos
嚘	yfot
牖	yfp
牗	yfpq
犹	yfq
猷	yfqc
酉	yfqp
猶	yfqq
狖	yfqs
酭	yfqt
獶	yfqu
獿	yfqv
幽	yfs
鼬	yfsp
峟	yfsq
祐	yfss
峳	yfst
禉	yfsu
由	yft
甴	yftq
亴	yfts
莠	yfu
莸	yfuc
莜	yfup
蕕	yfuq
苃	yfus
莤	yfut
优	yfv
攸	yfvc
侑	yfvd
佑	yfvp
優	yfvq
偤	yfvs
囿	yfw
忧	yfx
悠	yfxp
憂	yfxq
怞	yfxs
怮	yfxt
怣	yfxu
懮	yfxv
又	yfy
尤	yfyc
诱	yfyd
幼	yfye
尢	yfyf
鱿	yfyg
友	yfyp
誘	yfyq
魷	yfys
羑	yfyt
訧	yfyu
鲉	yfyv
羪	yfyw
鮋	yfyx
遊	yfzq
孧	yfzs
迶	yfzt
逌	yfzu
逰	yfzv
貁	yfzw
邎	yfzx
扚	ygaq
抈	ygas
捳	ygat
擽	ygau
髺	ygbq
軏	ygcq
蚎	ygcs
蚏	ygct
刖	ygd
瀹	yge
兌	ygeq
兊	yges
泧	yget
约	ygf
約	ygfq
戉	yggq
黦	yghq
爚	yghs
栎	ygi
樾	ygip
樂	ygiq
櫟	ygis
枂	ygit
楽	ygiu
钥	ygj
钺	ygjp
鑰	ygjq
鉞	ygjs
鈅	ygjt
箹	ygkq
篗	ygks
籆	ygkt
籥	ygku
籰	ygkv
月	ygl
臒	yglq
阅	ygm
粤	ygmp
粵	ygmq
閱	ygms
閲	ygmt
矆	ygmu
妜	ygnq
嬳	ygns
鸑	ygnt
鸙	ygnu
哕	ygo
噦	ygoq
哾	ygos
啘	ygot
乐	ygp
曰	ygr
曱	ygrq
岳	ygs
嶽	ygsq
岄	ygss
礿	ygst
矱	ygsu
禴	ygsv
藥	yguq
蘥	ygus
玥	ygwq
悦	ygx
悅	ygxq
恱	ygxs
说	ygy
龠	ygyp
說	ygyq
説	ygys
越	ygz
跃	ygzp
躍	ygzq
跀	ygzs
趯	ygzt
扬	yha
揚	yhaq
抰	yhas
攁	yhat
养	yhb
疡	yhbc
痒	yhbp
瘍	yhbq
癢	yhbs
徉	yhc
蛘	yhcp
軮	yhcq
蝆	yhcs
輰	yhct
央	yhd
殃	yhdp
洋	yhe
泱	yhec
漾	yhep
瀁	yheq
阳	yhf
陽	yhfq
阦	yhfs
飏	yhft
紻	yhfu
颺	yhfv
鞅	yhg
秧	yhh
烊	yhhc
炀	yhhp
煬	yhhq
炴	yhhs
样	yhi
杨	yhip
楊	yhiq
樣	yhis
柍	yhit
楧	yhiu
様	yhiv
卬	yhjq
钖	yhjs
锳	yhjt
鉠	yhju
鍈	yhjv
鍚	yhjw
劷	yhlq
胦	yhls
勜	yhlt
眏	yhmq
眻	yhms
駚	yhmt
鸯	yhn
鴦	yhnq
姎	yhns
婸	yhnt
鴹	yhnu
鸉	yhnv
咉	yhoq
礢	yhpq
氧	yhq
氜	yhqq
氱	yhqs
旸	yhrq
昜	yhrs
雵	yhrt
暘	yhru
霷	yhrv
養	yhsq
岟	yhss
崸	yhst
崵	yhsu
飬	yhsv
禓	yhsw
坱	yhtq
垟	yhts
仰	yhv
佯	yhvp
佒	yhvq
傟	yhvs
玚	yhwq
珜	yhws
瑒	yhwt
敭	yhwu
怏	yhx
恙	yhxp
愓	yhxq
慃	yhxs
懩	yhxt
羊	yhy
詳	yhyq
羏	yhys
羕	yhyt
詇	yhyu
諹	yhyv
鰑	yhyw
抑	yia
挹	yiac
揖	yiap
扡	yiaq
拸	yias
掜	yiat
撎	yiau
疑	yib
疫	yibc
肄	yibd
贻	yibe
痍	yibf
瘗	yibg
癔	yibh
贀	yibl
寱	yibm
寲	yibn
賹	yibo
宜	yibp
貽	yibq
瘞	yibs
匇	yibt
宐	yibu
貤	yibv
宧	yibw
痬	yibx
兿	yiby
瘱	yibz
蛇	yic
蚁	yicc
轶	yicd
蜴	yice
齸	yick
齮	yicl
轙	yicm
螠	yicn
螔	yico
役	yicp
蟻	yicq
軼	yics
彵	yict
虵	yicu
蛦	yicv
蛜	yicw
蛡	yicx
輢	yicy
螘	yicz
义	yid
刈	yidc
奕	yidd
殪	yide
劓	yidf
夷	yidp
殔	yidq
已	yie
沂	yiec
漪	yied
瀷	yiem
澺	yien
潩	yieo
溢	yiep
沶	yieq
泆	yies
洟	yiet
洢	yieu
浂	yiev
浳	yiew
浥	yiex
渏	yiey
湙	yiez
医	yif
缢	yifc
旖	yifd
繶	yifo
绎	yifp
繹	yifq
縊	yifs
匜	yift
阣	yifu
耴	yifv
郼	yifw
鄓	yifx
旑	yify
繄	yifz
异	yig
羿	yigc
弈	yigp
庡	yigq
弬	yigs
骮	yigt
廙	yigu
一	yih
熠	yihc
黟	yihd
燱	yihi
燡	yihj
燚	yihk
穓	yihl
熤	yihm
熪	yihn
熼	yiho
移	yihp
秇	yihq
炈	yihs
扅	yiht
扆	yihu
焬	yihv
焲	yihw
煕	yihx
稦	yihy
黓	yihz
椅	yii
檥	yiii
檍	yiij
槸	yiik
榏	yiil
椸	yiim
椬	yiin
棭	yiio
杙	yiiq
杝	yiis
枍	yiit
枻	yiiu
柂	yiiv
桋	yiiw
栧	yiix
栺	yiiy
栘	yiiz
铱	yij
镒	yijc
镱	yijd
觺	yijk
鏔	yijl
鉯	yijm
鈠	yijn
鈘	yijo
钇	yijp
銥	yijq
釔	yijs
鎰	yijt
鐿	yiju
帠	yijv
帟	yijw
釴	yijx
釶	yijy
幆	yijz
衣	yik
衤	yikc
襼	yikm
籎	yikn
簃	yiko
裔	yikp
衪	yikq
笖	yiks
袣	yikt
袘	yiku
裛	yikv
裿	yikw
篒	yikx
箷	yiky
褹	yikz
翌	yil
胰	yilc
翊	yild
臆	yilp
肊	yilq
劮	yils
勚	yilt
竩	yilu
勩	yilv
膉	yilw
益	yim
眙	yimc
驿	yimp
睪	yimq
驛	yims
冝	yimt
駅	yimu
瞖	yimv
姨	yin
鶃	yini
鶂	yinj
鶍	yink
鴺	yinl
嬟	yinm
嬑	yinn
鹥	yino
乁	yinq
妷	yins
鳦	yint
媐	yinu
嫛	yinv
嫕	yinw
鹝	yinx
鹢	yiny
嬄	yinz
邑	yio
咦	yioc
咿	yiod
嗌	yioe
噫	yiof
呓	yiop
囈	yioq
吚	yios
呭	yiot
呹	yiou
唈	yiov
毅	yip
殹	yipq
毉	yips
礒	yipt
酏	yiq
欹	yiqc
猗	yiqp
醫	yiqq
欥	yiqs
狋	yiqt
狏	yiqu
欭	yiqv
獈	yiqw
歝	yiqx
醳	yiqy
醷	yiqz
易	yir
昳	yirq
晹	yirs
暆	yirt
曀	yiru
曎	yirv
霬	yirw
靉	yirx
矣	yis
壹	yisc
峄	yisd
饴	yise
嶷	yisf
饐	yisk
豷	yisl
嶬	yism
夁	yisn
禕	yiso
屹	yisp
飴	yisq
嶧	yiss
壱	yist
祎	yisu
峓	yisv
巸	yisw
豛	yisx
豙	yisy
崺	yisz
亦	yit
埸	yitc
圯	yitp
異	yitq
坄	yits
垼	yitt
埶	yitu
畩	yitv
墿	yitw
艾	yiu
苡	yiuc
荑	yiud
薏	yiue
虉	yiuo
艺	yiup
藝	yiuq
芅	yius
苅	yiut
苢	yiuu
萟	yiuv
萓	yiuw
蓺	yiux
藙	yiuy
蘙	yiuz
以	yiv
伊	yivc
仪	yivd
亿	yive
乙	yivf
倚	yivg
佚	yivh
佾	yivi
儗	yivo
依	yivp
億	yivq
儀	yivs
乚	yivt
伇	yivu
佁	yivv
侇	yivw
俋	yivx
偯	yivy
亄	yivz
斁	yiwo
攺	yiwq
玴	yiws
珆	yiwt
瓵	yiwu
敧	yiwv
敡	yiww
敼	yiwx
瑿	yiwy
圛	yiwz
意	yix
彝	yixc
怿	yixd
怡	yixe
悒	yixf
懿	yixg
彞	yixm
懝	yixn
彛	yixo
忆	yixp
憶	yixq
彜	yixs
懌	yixt
乂	yixu
忔	yixv
怈	yixw
恞	yixx
悘	yixy
悥	yixz
议	yiy
译	yiyc
谊	yiyd
诣	yiye
颐	yiyf
弋	yiyg
诒	yiyh
翳	yiyi
詑	yiyj
詍	yiyk
羛	yiyl
訳	yiym
訲	yiyn
訑	yiyo
翼	yiyp
詣	yiyq
義	yiys
誼	yiyt
頤	yiyu
譯	yiyv
議	yiyw
詒	yiyx
弌	yiyy
叕	yiyz
遗	yiz
迤	yizc
舣	yizd
貖	yizk
艗	yizl
踦	yizm
跠	yizn
跇	yizo
逸	yizp
遺	yizq
艤	yizs
辷	yizt
迆	yizu
迱	yizv
迻	yizw
逘	yizx
隿	yizy
攲	yizz
抎	ykaq
抣	ykas
匀	ykb
勻	ykbq
疺	ykbs
貟	ykbt
賱	ykbu
赟	ykbv
贇	ykbw
蝹	ykcq
齫	ykcs
齳	ykct
殒	ykd
殞	ykdq
夽	ykds
奫	ykdt
允	yke
沄	ykeq
涢	ykes
涒	yket
溳	ykeu
澐	ykev
陨	ykf
纭	ykfc
郓	ykfd
縕	ykfn
縜	ykfo
郧	ykfp
鄖	ykfq
隕	ykfs
紜	ykft
鄆	ykfu
阭	ykfv
耺	ykfw
缊	ykfx
緼	ykfy
緷	ykfz
鞰	ykgq
云	ykh
熨	ykhp
秐	ykhq
煴	ykhs
煇	ykht
熉	ykhu
煾	ykhv
熅	ykhw
枟	ykiq
榅	ykis
橒	ykit
鈗	ykjq
鋆	ykjs
筠	ykk
筼	ykkq
褞	ykks
篔	ykkt
耘	ykl
腪	yklq
眃	ykmq
馻	ykms
媼	yknq
妘	ykns
員	ykoq
喗	ykos
磒	ykpq
酝	ykq
氲	ykqc
狁	ykqp
醞	ykqq
氳	ykqs
醖	ykqt
晕	ykr
昀	ykrp
雲	ykrq
暈	ykrs
霣	ykrt
餫	yksq
畇	yktq
蕴	yku
芸	ykup
蘊	ykuq
蕓	ykus
荺	ykut
蒀	ykuu
蒷	ykuv
蒕	ykuw
蕰	ykux
薀	ykuy
藴	ykuz
伝	ykvq
傊	ykvs
韫	ykw
韞	ykwq
囩	ykws
玧	ykwt
韗	ykwu
恽	ykx
愠	ykxp
惲	ykxq
慍	ykxs
愪	ykxt
馧	ykxu
韵	yky
韻	ykyq
运	ykz
孕	ykzp
運	ykzq
掩	yla
抁	ylaq
掞	ylas
揜	ylat
揅	ylau
宴	ylb
贗	ylbq
贋	ylbs
厌	ylc
蜒	ylcc
厣	ylcd
赝	ylce
衍	ylcp
厭	ylcq
厴	ylcs
蝘	ylct
厳	ylcu
齞	ylcv
齴	ylcw
奄	yld
剡	yldp
夵	yldq
剦	ylds
殗	yldt
演	yle
淹	ylec
湮	yled
滟	ylee
灧	ylem
灎	ylen
灔	yleo
沿	ylep
兗	yleq
灩	yles
沇	ylet
洝	yleu
淊	ylev
渰	ylew
渷	ylex
溎	yley
漹	ylez
郾	ylf
鄢	ylfp
郔	ylfq
匽	ylfs
隁	ylft
隒	ylfu
綖	ylfv
縯	ylfw
酀	ylfx
豓	ylfy
豔	ylfz
魇	ylg
魘	ylgq
弇	ylgs
戭	ylgt
鬳	ylgu
严	ylh
焰	ylhc
炎	ylhd
燕	ylhe
焉	ylhf
焱	ylhg
黶	ylhi
黰	ylhj
黭	ylhk
黬	ylhl
黫	ylhm
爓	ylhn
黤	ylho
烟	ylhp
煙	ylhq
炏	ylhs
烻	ylht
焔	ylhu
扊	ylhv
熖	ylhw
虤	ylhx
燄	ylhy
黡	ylhz
檐	yli
欕	ylio
梴	yliq
棪	ylis
椻	ylit
椼	yliu
楌	yliv
樮	yliw
橪	ylix
檿	yliy
櫩	yliz
鉛	yljq
觃	yljs
覎	yljt
觾	ylju
筵	ylk
裺	ylkq
褗	ylks
篶	ylkt
簷	ylku
胭	yll
腌	yllp
鹽	yllq
臙	ylls
龑	yllt
麣	yllu
眼	ylm
阎	ylmc
盐	ylmd
阉	ylme
闫	ylmf
阏	ylmg
验	ylmp
閹	ylmq
閻	ylms
驗	ylmt
閆	ylmu
閼	ylmv
験	ylmw
騐	ylmx
騴	ylmy
驠	ylmz
妍	yln
鷰	ylng
孍	ylnh
鷃	ylni
鶠	ylnj
嬿	ylnk
鴳	ylnl
嬮	ylnm
嬐	ylnn
鴈	ylno
嫣	ylnp
妟	ylnq
牪	ylns
姸	ylnt
娫	ylnu
姲	ylnv
娮	ylnw
鳫	ylnx
鳱	ylny
嬊	ylnz
咽	ylo
唁	ylop
嚴	yloq
唌	ylos
啱	ylot
喦	ylou
喭	ylov
噞	ylow
嚈	ylox
嚥	yloy
囐	yloz
研	ylp
砚	ylpc
殷	ylpp
硯	ylpq
硏	ylps
硽	ylpt
碞	ylpu
礹	ylpv
酽	ylq
釅	ylqq
狿	ylqs
酓	ylqt
猏	ylqu
猒	ylqv
歅	ylqw
醃	ylqx
醶	ylqy
醼	ylqz
晏	ylr
昖	ylrq
晻	ylrs
暥	ylrt
曕	ylru
曣	ylrv
曮	ylrw
岩	yls
彦	ylsc
崦	ylsd
罨	ylse
餍	ylsf
鼹	ylsg
巚	ylsh
巘	ylsi
巗	ylsj
軅	ylsk
巌	ylsl
艶	ylsm
躽	ylsn
嶖	ylso
艳	ylsp
彥	ylsq
巖	ylss
艷	ylst
鼴	ylsu
饜	ylsv
嵒	ylsw
嵓	ylsx
嵃	ylsy
嵼	ylsz
堰	ylt
埏	yltc
兖	yltp
塩	yltq
墕	ylts
壛	yltt
壧	yltu
芫	ylu
菸	ylup
莚	yluq
萒	ylus
蔅	ylut
俨	ylv
偃	ylvp
儼	ylvq
乵	ylvs
偐	ylvt
傿	ylvu
琰	ylw
珚	ylwq
琂	ylws
敥	ylwt
甗	ylwu
恹	ylx
懨	ylxq
愝	ylxs
窴	ylxt
懕	ylxu
言	yly
延	ylyc
谚	ylyd
讠	ylye
谳	ylyf
讌	ylyn
顩	ylyo
颜	ylyp
諺	ylyq
顏	ylys
訁	ylyt
讞	ylyu
訮	ylyv
詽	ylyw
羬	ylyx
顔	ylyy
鰋	ylyz
雁	ylz
趼	ylzp
遃	ylzq
哟	yoo
唷	yoop
喲	yooq
援	yra
掾	yrap
贠	yrbq
貟	yrbs
寃	yrbt
原	yrc
螈	yrcc
辕	yrcp
轅	yrcq
蚖	yrcs
衏	yrct
厡	yrcu
蜎	yrcv
蜵	yrcw
蝯	yrcx
蝝	yrcy
厵	yrcz
剈	yrdq
源	yre
沅	yrec
渊	yrep
淵	yreq
渁	yres
渆	yret
渕	yreu
涴	yrev
湲	yrew
溒	yrex
灁	yrey
院	yrf
缘	yrfp
緣	yrfq
邧	yrfs
縁	yrft
弲	yrgq
鼘	yrgs
鼝	yrgt
元	yrh
橼	yri
櫞	yriq
杬	yris
棩	yrit
楥	yriu
榬	yriv
榞	yriw
鈨	yrjq
鋺	yrjs
鎱	yrjt
箢	yrk
笎	yrkq
裷	yrks
裫	yrkt
褑	yrku
褤	yrkv
肙	yrlq
冤	yrm
鼋	yrmc
眢	yrmp
黿	yrmq
盶	yrms
駌	yrmt
騵	yrmu
鸳	yrn
媛	yrnc
鶰	yrnn
鶢	yrno
鸢	yrnp
鴛	yrnq
鳶	yrns
妧	yrnt
妴	yrnu
鹓	yrnv
媴	yrnw
嫄	yrnx
鵷	yrny
嬽	yrnz
员	yro
員	yroq
喛	yros
噮	yrot
猿	yrq
酛	yrqq
猨	yrqs
禐	yrsq
袁	yrt
垸	yrtc
塬	yrtd
垣	yrtp
円	yrtq
苑	yru
芫	yrup
茒	yruq
葾	yrus
蒝	yrut
蒬	yruu
薳	yruv
薗	yruw
傆	yrvq
圆	yrw
瑗	yrwc
圜	yrwd
园	yrwp
園	yrwq
圓	yrws
囦	yrwt
圎	yrwu
愿	yrx
怨	yrxp
夗	yrxq
悁	yrxs
惌	yrxt
願	yryq
魭	yrys
羱	yryt
謜	yryu
远	yrz
爰	yrzp
遠	yrzq
逺	yrzs
邍	yrzt
拥	ysa
擁	ysaq
揘	ysas
痈	ysb
癰	ysbq
癕	ysbs
蛹	ysc
邕	yscp
永	yse
泳	ysec
涌	ysep
湧	yseq
滽	yses
澭	yset
灉	yseu
鄘	ysfq
郺	ysfs
庸	ysg
廱	ysgq
栐	ysiq
柡	ysis
槦	ysit
镛	ysj
鏞	ysjq
銿	ysjs
勇	ysl
臃	yslp
勈	yslq
嫞	ysnq
鷛	ysns
咏	yso
喁	ysop
嗈	ysoq
噰	ysos
砽	yspq
硧	ysps
牗	yspt
牅	yspu
醟	ysqq
饔	yss
嵱	yssq
彮	ysss
雍	yst
壅	ystc
墉	ystp
埇	ystq
塎	ysts
苚	ysuq
蒏	ysus
佣	ysv
俑	ysvp
傭	ysvq
恿	ysx
慵	ysxp
怺	ysxq
悀	ysxs
惥	ysxt
愑	ysxu
愹	ysxv
慂	ysxw
用	ysy
鳙	ysyc
甬	ysyp
詠	ysyq
鱅	ysys
颙	ysyt
鲬	ysyu
顒	ysyv
鯒	ysyw
鰫	ysyx
踊	ysz
踴	yszq
雝	yszs
揄	yua
扜	yuaq
扝	yuas
扵	yuat
捓	yuau
挧	yuav
捥	yuaw
宇	yub
舆	yubc
瘐	yubd
瘀	yube
寓	yubp
痏	yubq
寙	yubs
瘉	yubt
癒	yubu
御	yuc
蜮	yucc
龉	yucd
蝓	yuce
尉	yucp
輿	yucq
齬	yucs
虶	yuct
輍	yucu
蜟	yucv
螸	yucw
轝	yucx
齵	yucy
奧	yudq
斞	yuds
渔	yue
淤	yuec
渝	yued
浴	yuep
漁	yueq
淢	yues
淯	yuet
湡	yueu
滪	yuev
潏	yuew
澞	yuex
澦	yuey
灪	yuez
郁	yuf
纡	yufc
於	yufd
旟	yufo
隅	yufp
紆	yufq
邘	yufs
陓	yuft
匬	yufu
鄅	yufv
隃	yufw
旕	yufx
隩	yufy
緎	yufz
庾	yug
鬻	yugp
骬	yugq
庽	yugs
戫	yugt
魊	yugu
髃	yugv
于	yuh
虞	yuhc
煜	yuhd
熨	yuhe
燠	yuhf
爩	yuhn
穥	yuho
与	yuhp
丂	yuhq
亐	yuhs
灹	yuht
秗	yuhu
焴	yuhv
稢	yuhw
穀	yuhx
稶	yuhy
燏	yuhz
榆	yui
鬱	yuik
鬰	yuil
欝	yuim
欎	yuin
櫲	yuio
杅	yuiq
栯	yuis
桙	yuit
棫	yuiu
楰	yuiv
棜	yuiw
棛	yuix
楀	yuiy
楡	yuiz
臾	yuj
钰	yujc
觎	yujd
鐭	yujn
鍝	yujo
舁	yujp
與	yujq
鈺	yujs
覦	yujt
釪	yuju
铻	yujv
銉	yujw
鋙	yujx
鋊	yujy
錥	yujz
裕	yuk
竽	yukp
籲	yukq
衧	yuks
袬	yukt
箊	yuku
褕	yukv
篽	yukw
籅	yukx
籞	yuky
育	yul
腴	yulc
禺	yulp
麌	yulq
驭	yum
盂	yumc
阈	yumd
毓	yume
粥	yump
馭	yumq
閾	yums
粖	yumt
盓	yumu
矞	yumv
睮	yumw
騟	yumx
驈	yumy
娱	yun
妤	yunc
鹆	yund
鹬	yune
鸒	yunh
鸆	yuni
鷠	yunj
嬩	yunk
鴧	yunl
鴪	yunm
鴥	yunn
鳿	yuno
妪	yunp
娛	yunq
嫗	yuns
鵒	yunt
鷸	yunu
娪	yunv
娯	yunw
媀	yunx
媮	yuny
婾	yunz
吁	yuo
喻	yuop
唹	yuoq
喅	yuos
喩	yuot
噳	yuou
禹	yup
砡	yupq
硢	yups
硲	yupt
牏	yupu
礇	yupv
礖	yupw
礜	yupx
欲	yuq
欤	yuqc
狳	yuqd
狱	yuqp
獄	yuqq
歟	yuqs
欥	yuqt
酑	yuqu
歈	yuqv
醧	yuqw
雨	yur
雩	yurc
昱	yurp
兪	yurq
霱	yurs
豫	yus
峪	yusc
饫	yusd
馀	yuse
嵛	yusf
軉	yusm
饇	yusn
嶎	yuso
屿	yusp
嶼	yusq
禦	yuss
崳	yust
飫	yusu
餘	yusv
彧	yusw
祤	yusx
嵎	yusy
罭	yusz
域	yut
畲	yutp
畬	yutq
圫	yuts
堉	yutt
堣	yutu
堬	yutv
芋	yuu
蓣	yuuc
蘌	yuul
蘛	yuum
藇	yuun
蕍	yuuo
萸	yuup
蕷	yuuq
芌	yuus
茰	yuut
茟	yuuu
萭	yuuv
萮	yuuw
蒮	yuux
薁	yuuy
蓹	yuuz
余	yuv
俞	yuvc
伛	yuvd
俣	yuve
予	yuvp
俁	yuvq
傴	yuvs
伃	yuvt
俼	yuvu
偊	yuvv
僪	yuvw
儥	yuvx
玉	yuw
圉	yuwc
瑜	yuwd
圄	yuwp
玗	yuwq
玙	yuws
敔	yuwt
琙	yuwu
琟	yuwv
瑀	yuww
璵	yuwx
斔	yuwy
愈	yux
愉	yuxc
窬	yuxd
窳	yuxe
愚	yuxp
忬	yuxq
穻	yuxs
悆	yuxt
惐	yuxu
慾	yuxv
懙	yuxw
语	yuy
鱼	yuyc
预	yuyd
誉	yuye
肀	yuyf
聿	yuyg
谀	yuyh
谕	yuyi
鯲	yuyk
謣	yuyl
頨	yuyn
羭	yuyo
羽	yuyp
魚	yuyq
預	yuys
語	yuyt
譽	yuyu
諛	yuyv
諭	yuyw
叞	yuyx
翑	yuyy
魣	yuyz
遇	yuz
迂	yuzc
雤	yuzo
逾	yuzp
込	yuzq
迃	yuzs
逳	yuzt
艅	yuzu
歶	yuzv
雓	yuzw
遹	yuzx
踰	yuzy
貐	yuzz
鱊	yvyi
鰅	yvyj
鮽	yvym
龥	yvyq
寅	yxb
瘾	yxbp
癮	yxbq
凐	yxbs
瘖	yxbt
癊	yxbu
蚓	yxc
龈	yxcp
齦	yxcq
龂	yxcs
輑	yxct
螾	yxcu
蟫	yxcv
齗	yxcw
殥	yxdq
淫	yxe
洇	yxep
洕	yxeq
泿	yxes
淾	yxet
湚	yxeu
溵	yxev
滛	yxew
濦	yxex
濥	yxey
阴	yxf
鄞	yxfc
隐	yxfp
陰	yxfq
隱	yxfs
阥	yxft
陻	yxfu
隂	yxfv
絪	yxfw
隠	yxfx
緸	yxfy
縯	yxfz
引	yxg
靷	yxgq
廕	yxgs
鞇	yxgt
烎	yxhq
秵	yxhs
栶	yxiq
梀	yxis
檃	yxit
檭	yxiu
檼	yxiv
櫽	yxiw
银	yxj
铟	yxjc
印	yxjp
銀	yxjq
銦	yxjs
斦	yxjt
鈝	yxju
鈏	yxjv
裀	yxkq
筃	yxks
冘	yxmq
骃	yxms
粌	yxmt
駰	yxmu
闉	yxmv
闇	yxmw
姻	yxn
婬	yxnq
婣	yxns
鷣	yxnt
吟	yxo
喑	yxoc
吲	yxop
唫	yxoq
噖	yxos
噾	yxot
嚚	yxou
殷	yxp
胤	yxpp
乑	yxpq
硍	yxps
碒	yxpt
磤	yxpu
氤	yxq
狺	yxqp
犾	yxqq
欭	yxqs
猌	yxqt
歅	yxqu
酳	yxqv
霪	yxr
朄	yxrq
霒	yxrs
霠	yxrt
饮	yxs
飲	yxsq
岃	yxss
峾	yxst
崟	yxsu
崯	yxsv
飮	yxsw
禋	yxsx
嶾	yxsy
垠	yxt
堙	yxtp
垔	yxtq
垽	yxts
堷	yxtt
茵	yxu
茚	yxuc
荫	yxup
蔭	yxuq
苂	yxus
荶	yxut
蒑	yxuu
蔩	yxuv
蘟	yxuw
尹	yxv
侌	yxvq
因	yxw
囙	yxwq
珢	yxws
圁	yxwt
璌	yxwu
夤	yxx
窨	yxxp
愔	yxxq
慇	yxxs
慭	yxxt
憖	yxxu
憗	yxxv
懚	yxxw
音	yxy
廴	yxyp
訔	yxyq
訚	yxys
訡	yxyt
誾	yxyu
鮣	yxyv
諲	yxyw
韾	yxyx
讔	yxyy
赺	yxzq
趛	yxzs
撄	yya
攖	yyaq
摬	yyas
攍	yyat
赢	yyb
瘿	yybp
贏	yybq
癭	yybs
賏	yybt
蝇	yyc
萤	yycp
螢	yycq
蠅	yycs
蛍	yyct
蝧	yycu
蝿	yycv
蠳	yycw
滢	yye
瀛	yyec
灜	yyej
灐	yyek
瀴	yyel
瀯	yyem
濙	yyen
濴	yyeo
潆	yyep
滎	yyeq
潁	yyes
瀅	yyet
瀠	yyeu
浧	yyev
渶	yyew
溁	yyex
溋	yyey
濚	yyez
缨	yyf
罂	yyfc
郢	yyfp
纓	yyfq
縈	yyfs
罌	yyft
耺	yyfu
绬	yyfv
緓	yyfw
罃	yyfx
应	yyg
鞕	yygq
廮	yygs
荧	yyh
熒	yyhq
穎	yyhs
營	yyht
焸	yyhu
焽	yyhv
煐	yyhw
爃	yyhx
樱	yyi
楹	yyip
櫻	yyiq
柍	yyis
桜	yyit
桯	yyiu
梬	yyiv
楧	yyiw
櫿	yyix
鎣	yyjq
锳	yyjs
覮	yyjt
鐛	yyju
鑍	yyjv
褮	yykq
籝	yyks
籯	yykt
媵	yyl
膺	yylp
朠	yylq
膡	yyls
盈	yym
盁	yymq
眏	yyms
婴	yyn
鹦	yync
鸎	yynm
鷪	yynn
孆	yyno
鹰	yynp
嬰	yynq
鷹	yyns
鶯	yynt
鸚	yynu
媖	yynv
嫈	yynw
鴬	yynx
鶧	yyny
鶑	yynz
嘤	yyo
嚶	yyoq
啨	yyos
営	yyot
噟	yyou
硬	yyp
碤	yypq
礯	yyps
映	yyr
旲	yyrq
暎	yyrs
霙	yyrt
影	yys
矨	yysq
嵤	yyss
禜	yyst
巆	yysu
巊	yysv
軈	yysw
嬴	yyt
塋	yytq
英	yyu
莹	yyuc
茔	yyud
荥	yyue
莺	yyuf
萦	yyug
蓥	yyuh
营	yyup
萾	yyuq
藀	yyus
蘡	yyut
偀	yyvq
僌	yyvs
瑛	yyw
璎	yywp
瑩	yywq
瓔	yyws
珱	yywt
甇	yywu
甖	yywv
應	yyxq
応	yyxs
愥	yyxt
颖	yyy
颍	yyyp
颕	yyyq
頴	yyys
韺	yyyt
謍	yyyu
譍	yyyv
譻	yyyw
鱦	yyyx
迎	yyz
夃	yyzq
孾	yyzs
黳	yzhq
檹	yziq
鷊	yznq
鷁	yzns
鷖	yznt
鷧	yznu
鸃	yznv
鷾	yznw
羠	yzyk
讛	yzyl
讉	yzym
譩	yzyn
鯣	yzyo
頉	yzyq
誃	yzys
叆	yzyt
頥	yzyu
顊	yzyv
鮧	yzyw
鮨	yzyx
謻	yzyy
顗	yzyz
拶	zaa
沞	zaeq
沯	zaes
匝	zaf
紮	zafq
紥	zafs
杂	zai
桚	zaiq
橴	zais
帀	zajq
鉔	zajs
襍	zakq
臜	zalq
臢	zals
咋	zao
咂	zaop
喒	zaoq
噈	zaos
囃	zaot
囋	zaou
囐	zaov
砸	zap
偺	zavq
韴	zayq
魳	zays
雜	zazq
雑	zazs
雥	zazt
皂	zcb
皁	zcbq
蚤	zcc
澡	zce
燥	zch
灶	zchp
煰	zchq
枣	zci
棗	zciq
栆	zcis
梍	zcit
鑿	zcjq
凿	zck
簉	zckq
糟	zcm
噪	zco
唣	zcop
唕	zcoq
喿	zcos
醩	zcqq
早	zcr
藻	zcu
薻	zcuq
傮	zcvq
璅	zcwq
璪	zcws
竈	zcxq
慥	zcxs
竃	zcxt
謲	zcyq
譟	zcys
造	zcz
躁	zczc
遭	zczp
艁	zczq
蹧	zczs
趮	zczt
扗	zdaq
抂	zdas
宰	zdb
賳	zdbq
载	zdc
載	zdcq
洅	zdeq
渽	zdes
溨	zdet
縡	zdfq
灾	zdh
災	zdhq
烖	zdhs
栽	zdi
睵	zdmq
哉	zdo
酨	zdqq
崽	zds
岾	zdsq
在	zdt
甾	zdtc
再	zdtp
畠	zdtq
菑	zduq
傤	zdvq
儎	zdvs
子	zdz
择	zea
擇	zeaq
択	zeas
捑	zeat
责	zeb
赜	zebp
責	zebq
賾	zebs
皟	zebt
仄	zec
蠌	zecq
齚	zecs
齰	zect
则	zed
則	zedq
泽	zee
澤	zeeq
汄	zees
沢	zeet
泎	zeeu
溭	zeev
滜	zeew
灂	zeex
庂	zegq
稄	zehq
樍	zeiq
帻	zej
幘	zejq
笮	zek
箦	zekp
簀	zekq
襗	zeks
耫	zelq
睪	zemq
矠	zems
瞔	zemt
嫧	zenq
鸅	zens
咋	zeo
啧	zeop
嘖	zeoq
啫	zeos
唶	zeot
礋	zepq
昃	zer
昗	zerq
崱	zesq
飵	zess
蔶	zeuq
側	zevq
諎	zeyq
謮	zeys
迮	zez
舴	zezp
歵	zezq
揍	zfa
掫	zfaq
搊	zfas
齱	zfcq
齺	zfcs
奏	zfd
邹	zff
鄹	zffc
陬	zffp
鄒	zffq
郰	zffs
緅	zfft
棸	zfiq
棷	zfis
箃	zfkq
驺	zfm
騶	zfmq
黀	zfms
媰	zfnq
菆	zfuq
蓙	zfus
诹	zfy
鲰	zfyp
諏	zfyq
鯫	zfys
鯐	zfyt
走	zfz
赱	zfzq
撍	zgaq
怎	zgx
谮	zgy
譖	zgyq
赃	zhb
贓	zhbq
賍	zhbs
賘	zhbt
贜	zhbu
奘	zhd
匨	zhfq
臧	zhg
弉	zhgq
髒	zhgs
欌	zhiq
銺	zhjq
脏	zhl
臟	zhlq
臓	zhls
驵	zhm
駔	zhmq
牂	zhpq
塟	zhtq
葬	zhu
蔵	zhuq
羘	zhyq
资	zib
赀	zibc
髭	zibd
兹	zibp
茲	zibq
資	zibs
貲	zibt
辎	zic
龇	zicp
輜	zicq
齜	zics
虸	zict
輺	zicu
剚	zidq
鼒	zids
滋	zie
淄	ziec
滓	zied
渍	ziep
漬	zieq
沝	zies
洓	ziet
湽	zieu
澬	ziev
紫	zif
缁	zifp
緇	zifq
紎	zifs
鄑	zift
緕	zifu
纃	zifv
秭	zih
秄	zihq
秶	zihs
稵	ziht
梓	zii
杍	ziiq
栥	ziis
椔	ziit
榟	ziiu
觜	zij
锱	zijp
錙	zijq
釨	zijs
鈭	zijt
镃	ziju
鍿	zijv
鎡	zijw
笫	zik
耔	zil
胏	zilq
胾	zils
胔	zilt
籽	zim
粢	zimc
眦	zimp
眥	zimq
姿	zin
姊	zinp
姉	zinq
姕	zins
牸	zint
鶅	zinu
咨	zio
呲	ziop
吇	zioq
呰	zios
啙	ziot
嗞	ziou
嗭	ziov
矷	zipq
齍	ziqq
嵫	zis
崰	zisq
禌	ziss
畠	zitq
茈	ziu
芓	ziuq
茊	zius
荢	ziut
茡	ziuu
菑	ziuv
葘	ziuw
蓻	ziux
薋	ziuy
仔	ziv
倳	zivq
璾	ziwq
恣	zix
玆	zixq
谘	ziy
鲻	ziyc
訾	ziyp
諮	ziyq
鯔	ziys
訿	ziyt
頾	ziyu
頿	ziyv
鰦	ziyw
子	ziz
字	zizc
孜	zizd
孳	zize
趑	zizf
自	zizp
孖	zizq
赼	zizs
孶	zizt
趦	zizu
撙	zka
拵	zkaq
捘	zkas
尊	zkc
瀳	zkeq
罇	zkfq
繜	zkfs
樽	zki
栫	zkiq
銌	zkjq
鐏	zkjs
袸	zkkq
鶎	zknq
鷷	zkns
噂	zkoq
嶟	zksq
墫	zktq
僔	zkvq
鳟	zky
鱒	zkyq
譐	zkys
遵	zkz
攒	zla
攢	zlaq
揝	zlas
撍	zlat
攅	zlau
赞	zlb
贊	zlbq
寁	zlbs
賛	zlbt
兂	zleq
濽	zles
灒	zlet
鄼	zlfq
酂	zlfs
酇	zlft
穳	zlhq
桚	zliq
橵	zlis
錾	zlj
鏨	zljq
鏩	zljs
鐟	zljt
鐕	zlju
簪	zlk
篸	zlkq
簮	zlks
襸	zlkt
糌	zlm
鵤	zlnq
咱	zlo
喒	zloq
噆	zlos
囋	zlot
暂	zlr
昝	zlrp
暫	zlrq
禶	zlsq
饡	zlss
塹	zltq
偺	zlvq
儧	zlvs
儹	zlvt
瓒	zlw
瓚	zlwq
瓉	zlws
讃	zlyq
讚	zlys
趱	zlz
趲	zlzq
蹔	zlzs
捽	zoaq
阼	zof
繓	zofq
左	zog
座	zogp
秨	zohq
稓	zohs
穝	zoht
柞	zoi
柮	zoiq
鈼	zojq
笮	zok
袏	zokq
筰	zoks
胙	zol
糳	zomq
唑	zoo
嘬	zoop
咗	zooq
唶	zoos
酢	zoq
昨	zor
祚	zos
岝	zosq
岞	zoss
飵	zost
坐	zot
苲	zouq
莋	zous
葃	zout
葄	zouu
作	zov
佐	zovc
做	zovp
侳	zovq
怍	zox
諎	zoyq
贼	zpb
賊	zpbq
蠈	zpcq
戝	zpgq
鲗	zpyq
鰂	zpys
鱡	zpyt
攥	zra
揝	zraq
賺	zrbq
劗	zrdq
缵	zrf
纘	zrfq
繤	zrfs
纉	zrft
钻	zrj
鉆	zrjq
鑚	zrjs
鑽	zrjt
纂	zrk
篹	zrkq
籫	zrks
躜	zrz
躦	zrzq
捴	zsaq
揌	zsas
揔	zsat
搃	zsau
摠	zsav
宗	zsb
鬃	zsbp
疭	zsbq
瘲	zsbs
鬉	zsbt
從	zscq
蝬	zscs
潀	zseq
潈	zses
潨	zset
综	zsf
繌	zsfo
纵	zsfp
綜	zsfq
總	zsfs
縱	zsft
緃	zsfu
総	zsfv
緵	zsfw
緫	zsfx
縂	zsfy
縦	zsfz
鬷	zsgq
焧	zshq
稯	zshs
熧	zsht
熜	zshu
燪	zshv
棕	zsi
樅	zsiq
椶	zsis
鍐	zsjq
鑁	zsjs
腙	zsl
朡	zslq
粽	zsm
骔	zsmq
糉	zsms
騌	zsmt
騣	zsmu
糭	zsmv
碂	zspq
磫	zsps
猔	zsqq
猣	zsqs
昮	zsrq
嵏	zssq
嵕	zsss
嵸	zsst
豵	zssu
堫	zstq
葼	zsuq
蓗	zsus
偬	zsv
傯	zsvq
倊	zsvs
倧	zsvt
总	zsx
惣	zsxq
惾	zsxs
翪	zsyq
鯮	zsys
鯼	zsyt
踪	zsz
蹤	zszq
踨	zszs
组	zuf
阻	zufc
族	zufp
組	zufq
靻	zugq
租	zuh
稡	zuhq
柤	zuiq
椊	zuis
镞	zuj
鏃	zujq
鎺	zujs
鎐	zujt
箤	zukq
哫	zuoq
唨	zuos
祖	zus
卒	zusp
卆	zusq
崒	zuss
崪	zust
菹	zuu
葅	zuuq
蒩	zuus
俎	zuv
倅	zuvq
珇	zuwq
怚	zuxq
爼	zuxs
诅	zuy
詛	zuyq
足	zuz
踤	zuzq
厜	zvcq
蟕	zvcs
濢	zveq
絊	zvfq
纗	zvfs
稡	zvhq
栬	zviq
槜	zvis
樶	zvit
檇	zviu
檌	zviv
欈	zviw
觜	zvj
鋷	zvjq
錊	zvjs
脧	zvlq
朘	zvls
冣	zvmq
睟	zvms
嘴	zvo
嗺	zvoq
噿	zvos
醉	zvq
酔	zvqq
酻	zvqs
最	zvr
晬	zvrq
罪	zvs
祽	zvsq
嶊	zvss
嶵	zvst
蕞	zvu
璻	zvwq
辠	zvxq
赠	zzb
贈	zzbq
缯	zzf
綜	zzfq
繒	zzfs
鄫	zzft
縡	zzfu
鬵	zzgq
熷	zzhq
橧	zziq
锃	zzj
鋥	zzjq
竲	zzlq
囎	zzoq
磳	zzpq
曽	zzrq
罾	zzs
矰	zzsq
增	zzt
増	zztq
甑	zzw
璔	zzwq
憎	zzx
譄	zzyq
鱛	zzys
