普逻码双拼

普逻码双拼键盘，韵母分布在除b以外的英文字母键上。
除w和b键外，一键连按2次都可组成一个音节，达到易记效果，如
qq=qiang,ee=e,rr=ruan,tt=tie,
yy=ying,uu=zhu,ii=shi,oo=o,pp=pei,
aa=a,ss=song,dd=dai,ff=fou,gg=gen,
hh=hang,jj=jian,kk=kun,ll=lian,
zz=zeng,xx=xin,cc=cao,vv=chui,nn=niu,mm=miao 。

nen和nue的双拼同为ng，有些输入法不支持，可将音节nue定为nb，或把韵母ue安排到b键上。

具体双拼设置：
(声母)
zh=u
ch=v
sh=i

(零声母音节)
a=aa
ang=ag
e=ee
eng=eg
o=oo

(韵母)
ai=d
ei=p
ui=v

ao=c
ou=f
iu=n

ie=t
ue=g
er

an=l
en=g
in=x
un=k
vn

ang=h
eng=z
ing=y
ong=s

ia=w
iao=m
ian=j
iang=q
iong=s

ua=w
uai=y
uan=r
uo=o
uang=q
